gameId,year,gameWeek,awayTeam.fullName,awayTeam.score,homeTeam.fullName,homeTeam.score,results.winner.correct,results.winner.push,results.spread.correct,results.spread.push,results.total.correct,results.total.push,spread,total,submitted,userId,predictionScore
-4,2018,-3,Cleveland Browns,18,New York Giants,24,0,0,1,0,1,0,-6,42,2018-08-08T23:20:08.481Z,Facebook_10155298489409129,4
-5,2018,-3,Cleveland Browns,18,New York Giants,24,0,0,1,0,0,0,-6,42,2018-08-08T23:20:08.481Z,Facebook_10155298489409129,2
-39,2018,-3,Los Angeles Rams,17,Oakland Raiders,13,1,0,0,0,1,0,4,30,2018-08-18T18:30:07.404Z,cmaronchick-yahoo,4
-38,2018,-3,Dallas Cowboys,21,Cincinnati Bengals,26,1,0,0,0,0,0,-5,47,2018-08-18T18:30:28.698Z,cmaronchick-yahoo,3
-37,2018,-3,Tennessee Titans,19,Tampa Bay Buccaneers,22,1,0,0,0,0,0,-3,41,2018-08-18T18:30:40.720Z,cmaronchick-yahoo,2
-36,2018,-3,Houston Texans,16,San Francisco 49ers,25,0,0,0,1,1,0,-9,41,2018-08-18T18:30:53.240Z,cmaronchick-yahoo,2
-35,2018,-3,Denver Broncos,23,Chicago Bears,13,0,0,1,0,0,0,10,36,2018-08-18T18:31:56.537Z,cmaronchick-yahoo,2
-34,2018,-3,Los Angeles Chargers,15,Seattle Seahawks,23,0,0,1,0,1,0,-8,38,2018-08-18T18:32:11.779Z,cmaronchick-yahoo,5
-23,2018,-2,Houston Texans,16,Los Angeles Rams,21,1,0,0,0,1,0,-5,37,2018-08-22T05:09:45.097Z,cmaronchick-gmail,5
-21,2018,-2,Atlanta Falcons,19,Jacksonville Jaguars,17,0,0,0,0,1,0,2,36,2018-08-22T05:11:08.075Z,cmaronchick-gmail,3
-20,2018,-2,Baltimore Ravens,24,Miami Dolphins,14,1,0,1,0,1,0,10,38,2018-08-22T05:11:20.056Z,cmaronchick-gmail,6
-19,2018,-2,New Orleans Saints,24,Los Angeles Chargers,18,1,0,1,0,1,0,6,42,2018-08-22T05:11:53.135Z,cmaronchick-gmail,6
-17,2018,-2,Arizona Cardinals,24,Dallas Cowboys,20,1,0,1,0,0,0,4,44,2018-08-22T05:12:29.976Z,cmaronchick-gmail,4
-22,2018,-2,San Francisco 49ers,24,Indianapolis Colts,14,0,0,0,0,1,0,10,38,2018-08-22T05:58:30.195Z,cmaronchick-gmail,2
-31,2018,-2,New York Giants,24,New York Jets,20,1,0,1,0,0,0,4,44,2018-08-22T06:15:18.996Z,cmaronchick-hotmail,4
-30,2018,-2,Denver Broncos,17,Washington Redskins,21,0,0,0,0,0,0,-4,38,2018-08-22T06:17:15.158Z,cmaronchick-hotmail,0
-29,2018,-2,New England Patriots,27,Carolina Panthers,17,0,0,0,0,1,0,10,44,2018-08-22T06:18:59.358Z,cmaronchick-hotmail,2
-28,2018,-2,Detroit Lions,19,Tampa Bay Buccaneers,13,1,0,1,0,0,0,6,32,2018-08-22T06:22:05.656Z,cmaronchick-hotmail,4
-31,2018,-2,New York Giants,19,New York Jets,16,1,0,1,0,1,0,3,35,2018-08-22T18:24:00.651Z,Facebook_10155298489409129,7
-30,2018,-2,Denver Broncos,14,Washington Redskins,18,0,0,0,0,0,0,-4,32,2018-08-22T18:26:10.384Z,Facebook_10155298489409129,0
-28,2018,-2,Detroit Lions,19,Tampa Bay Buccaneers,13,1,0,1,0,0,0,6,32,2018-08-22T18:44:33.824Z,Facebook_10155298489409129,4
-17,2018,-2,Arizona Cardinals,24,Dallas Cowboys,17,1,0,1,0,1,0,7,41,2018-08-22T18:56:52.145Z,Facebook_10155298489409129,6
-27,2018,-2,Seattle Seahawks,27,Minnesota Vikings,21,0,0,1,0,1,0,6,48,2018-08-22T19:06:48.786Z,Facebook_10155298489409129,5
-26,2018,-2,Green Bay Packers,25,Oakland Raiders,16,0,0,0,1,0,0,9,41,2018-08-22T19:08:38.391Z,Facebook_10155298489409129,0
-25,2018,-2,Kansas City Chiefs,23,Chicago Bears,16,0,0,0,0,1,0,7,39,2018-08-22T19:11:20.406Z,Facebook_10155298489409129,2
-32,2018,-2,Philadelphia Eagles,24,Cleveland Browns,16,0,0,0,0,1,0,8,40,2018-08-23T17:33:03.407Z,cmaronchick-gmail,2
-27,2018,-2,Seattle Seahawks,27,Minnesota Vikings,21,0,0,1,0,1,0,6,48,2018-08-23T06:53:47.449Z,cmaronchick-hotmail,5
-24,2018,-2,Tennessee Titans,17,Pittsburgh Steelers,20,1,0,0,0,1,0,-3,37,2018-08-23T18:04:49.526Z,cmaronchick-gmail,4
-26,2018,-2,Green Bay Packers,19,Oakland Raiders,13,0,0,0,1,1,0,6,32,2018-08-23T17:47:02.365Z,cmaronchick-gmail,3
-29,2018,-2,New England Patriots,24,Carolina Panthers,14,0,0,0,0,1,0,10,38,2018-08-23T23:58:42.410Z,Facebook_10154993923975769,2
-30,2018,-2,Denver Broncos,35,Washington Redskins,21,1,0,1,0,1,0,14,56,2018-08-23T23:58:53.047Z,Facebook_10154993923975769,6
-31,2018,-2,New York Giants,18,New York Jets,21,0,0,0,0,1,0,-3,39,2018-08-23T23:59:03.989Z,Facebook_10154993923975769,2
-27,2018,-2,Seattle Seahawks,28,Minnesota Vikings,14,0,0,1,0,1,0,14,42,2018-08-23T23:59:19.608Z,Facebook_10154993923975769,4
-28,2018,-2,Detroit Lions,7,Tampa Bay Buccaneers,14,0,0,0,0,0,0,-7,21,2018-08-23T23:59:33.047Z,Facebook_10154993923975769,0
-26,2018,-2,Green Bay Packers,28,Oakland Raiders,24,0,0,0,1,0,0,4,52,2018-08-23T23:59:42.668Z,Facebook_10154993923975769,0
-25,2018,-2,Kansas City Chiefs,28,Chicago Bears,34,1,0,1,0,0,0,-6,62,2018-08-23T23:59:59.092Z,Facebook_10154993923975769,4
-23,2018,-2,Houston Texans,16,Los Angeles Rams,19,1,0,0,0,1,0,-3,35,2018-08-24T00:00:08.173Z,Facebook_10154993923975769,4
-24,2018,-2,Tennessee Titans,18,Pittsburgh Steelers,14,0,0,0,0,1,0,4,32,2018-08-24T00:00:22.769Z,Facebook_10154993923975769,2
-22,2018,-2,San Francisco 49ers,21,Indianapolis Colts,28,1,0,1,0,0,0,-7,49,2018-08-24T00:00:32.909Z,Facebook_10154993923975769,4
-20,2018,-2,Baltimore Ravens,35,Miami Dolphins,42,0,0,0,0,0,0,-7,77,2018-08-24T00:00:44.170Z,Facebook_10154993923975769,0
-21,2018,-2,Atlanta Falcons,14,Jacksonville Jaguars,18,1,0,1,0,1,0,-4,32,2018-08-24T00:00:54.847Z,Facebook_10154993923975769,6
-19,2018,-2,New Orleans Saints,28,Los Angeles Chargers,24,1,0,1,0,0,0,4,52,2018-08-24T00:01:05.867Z,Facebook_10154993923975769,4
-18,2018,-2,Cincinnati Bengals,28,Buffalo Bills,24,1,0,1,0,0,0,4,52,2018-08-24T00:01:16.727Z,Facebook_10154993923975769,4
-17,2018,-2,Arizona Cardinals,18,Dallas Cowboys,7,1,0,1,0,1,0,11,25,2018-08-24T00:10:05.791Z,Facebook_10154993923975769,6
-25,2018,-2,Kansas City Chiefs,22,Chicago Bears,15,0,0,0,0,1,0,7,37,2018-08-24T01:52:51.368Z,cmaronchick-hotmail,2
-23,2018,-2,Houston Texans,18,Los Angeles Rams,22,1,0,0,0,1,0,-4,40,2018-08-24T01:53:07.730Z,cmaronchick-hotmail,4
-22,2018,-2,San Francisco 49ers,23,Indianapolis Colts,17,0,0,0,0,1,0,6,40,2018-08-24T01:54:18.028Z,cmaronchick-hotmail,3
-20,2018,-2,Baltimore Ravens,24,Miami Dolphins,16,1,0,1,0,1,0,8,40,2018-08-24T01:54:43.589Z,cmaronchick-hotmail,6
-21,2018,-2,Atlanta Falcons,28,Jacksonville Jaguars,22,0,0,0,0,0,0,6,50,2018-08-24T01:55:12.608Z,cmaronchick-hotmail,0
-19,2018,-2,New Orleans Saints,34,Los Angeles Chargers,31,1,0,1,0,0,0,3,65,2018-08-24T01:55:27.727Z,cmaronchick-hotmail,4
-18,2018,-2,Cincinnati Bengals,17,Buffalo Bills,20,0,0,0,0,1,0,-3,37,2018-08-24T01:55:40.548Z,cmaronchick-hotmail,2
-26,2018,-2,Green Bay Packers,17,Oakland Raiders,20,1,0,0,1,1,0,-3,37,2018-08-24T02:02:58.928Z,cmaronchick-hotmail,4
-24,2018,-2,Tennessee Titans,19,Pittsburgh Steelers,22,1,0,0,0,1,0,-3,41,2018-08-24T02:03:11.047Z,cmaronchick-hotmail,4
-17,2018,-2,Arizona Cardinals,12,Dallas Cowboys,18,0,0,0,0,1,0,-6,30,2018-08-24T02:03:27.888Z,cmaronchick-hotmail,3
-30,2018,-2,Denver Broncos,32,Washington Redskins,17,1,0,1,0,1,0,15,49,2018-08-24T03:36:14.169Z,Facebook_10210894378652618,7
-31,2018,-2,New York Giants,18,New York Jets,21,0,0,0,0,1,0,-3,39,2018-08-24T03:36:22.349Z,Facebook_10210894378652618,2
-27,2018,-2,Seattle Seahawks,9,Minnesota Vikings,17,1,0,0,0,0,0,-8,26,2018-08-24T03:36:45.731Z,Facebook_10210894378652618,2
-28,2018,-2,Detroit Lions,10,Tampa Bay Buccaneers,23,0,0,0,0,0,0,-13,33,2018-08-24T03:36:42.029Z,Facebook_10210894378652618,0
-26,2018,-2,Green Bay Packers,28,Oakland Raiders,17,0,0,0,1,0,0,11,45,2018-08-24T03:36:59.852Z,Facebook_10210894378652618,0
-25,2018,-2,Kansas City Chiefs,11,Chicago Bears,10,0,0,0,0,1,0,1,21,2018-08-24T03:37:25.730Z,Facebook_10210894378652618,2
-22,2018,-2,San Francisco 49ers,17,Indianapolis Colts,10,0,0,0,0,1,0,7,27,2018-08-24T03:37:49.409Z,Facebook_10210894378652618,3
-20,2018,-2,Baltimore Ravens,21,Miami Dolphins,10,1,0,1,0,1,0,11,31,2018-08-24T03:37:53.867Z,Facebook_10210894378652618,7
-21,2018,-2,Atlanta Falcons,24,Jacksonville Jaguars,10,0,0,0,0,1,0,14,34,2018-08-24T03:38:01.774Z,Facebook_10210894378652618,2
-19,2018,-2,New Orleans Saints,28,Los Angeles Chargers,14,1,0,1,0,1,0,14,42,2018-08-24T03:38:10.586Z,Facebook_10210894378652618,6
-18,2018,-2,Cincinnati Bengals,11,Buffalo Bills,17,0,0,0,0,1,0,-6,28,2018-08-24T03:38:17.367Z,Facebook_10210894378652618,2
-24,2018,-2,Tennessee Titans,14,Pittsburgh Steelers,27,1,0,1,0,1,0,-13,41,2018-08-24T03:49:45.194Z,Facebook_10210894378652618,6
-17,2018,-2,Arizona Cardinals,24,Dallas Cowboys,11,1,0,1,0,1,0,13,35,2018-08-24T03:49:52.748Z,Facebook_10210894378652618,6
-32,2018,-2,Philadelphia Eagles,23,Cleveland Browns,10,0,0,0,0,1,0,13,33,2018-08-23T06:58:47.748Z,cmaronchick-hotmail,2
-32,2018,-2,Philadelphia Eagles,21,Cleveland Browns,18,0,0,0,0,1,0,3,39,2018-08-23T23:58:26.850Z,Facebook_10154993923975769,2
-33,2018,-3,Baltimore Ravens,23,Indianapolis Colts,15,1,0,0,0,1,0,8,38,2018-08-20T19:00:46.332Z,Facebook_10155298489409129,4
-32,2018,-2,Philadelphia Eagles,20,Cleveland Browns,10,0,0,0,0,1,0,10,30,2018-08-22T18:16:36.327Z,Facebook_10155298489409129,2
-30,2018,-2,Denver Broncos,24,Washington Redskins,27,0,0,0,0,1,0,-3,51,2018-08-24T05:33:06.565Z,cmaronchick-gmail,2
-29,2018,-2,New England Patriots,27,Carolina Panthers,22,0,0,0,0,0,0,5,49,2018-08-22T19:07:03.949Z,Facebook_10155298489409129,0
-29,2018,-2,New England Patriots,24,Carolina Panthers,11,0,0,0,0,1,0,13,35,2018-08-24T03:36:03.569Z,Facebook_10210894378652618,2
-25,2018,-2,Kansas City Chiefs,15,Chicago Bears,17,1,0,0,0,1,0,-2,32,2018-08-25T03:53:45.042Z,cmaronchick-gmail,4
-13,2018,-1,Cleveland Browns,9,Detroit Lions,14,0,0,0,0,0,0,-5,23,2018-08-27T17:47:57.879Z,cmaronchick-gmail,0
-16,2018,-1,Miami Dolphins,12,Atlanta Falcons,17,0,0,0,0,0,0,-5,29,2018-08-27T19:42:01.721Z,cmaronchick-gmail,0
-5,2018,-1,Dallas Cowboys,18,Houston Texans,24,1,0,1,0,0,0,-6,42,2018-08-28T20:44:33.344Z,cmaronchick-gmail,4
-8,2018,-1,Buffalo Bills,18,Chicago Bears,12,1,0,1,0,0,0,6,30,2018-08-28T20:49:49.184Z,cmaronchick-gmail,4
-3,2018,-1,Denver Broncos,23,Arizona Cardinals,13,1,0,1,0,0,0,10,36,2018-08-28T20:50:25.186Z,cmaronchick-gmail,4
-1,2018,-1,Oakland Raiders,17,Seattle Seahawks,20,0,0,0,0,1,0,-3,37,2018-08-28T20:50:34.445Z,cmaronchick-gmail,2
-2,2018,-1,Los Angeles Chargers,13,San Francisco 49ers,16,0,0,1,0,0,0,-3,29,2018-08-28T20:50:55.483Z,cmaronchick-gmail,2
-18,2018,-2,Cincinnati Bengals,13,Buffalo Bills,20,0,0,0,0,1,0,-7,33,2018-08-26T16:58:20.489Z,cmaronchick-gmail,2
-3,2018,-1,Denver Broncos,22,Arizona Cardinals,28,0,0,0,0,0,0,-6,50,2018-08-30T04:26:50.181Z,Facebook_10210894378652618,0
-12,2018,-1,New England Patriots,18,New York Giants,15,1,0,1,0,1,0,3,33,2018-08-30T16:27:29.268Z,cmaronchick-hotmail,6
-3,2018,-1,Denver Broncos,20,Arizona Cardinals,13,1,0,1,0,1,0,7,33,2018-08-30T18:21:05.076Z,cmaronchick,6
-13,2018,-1,Cleveland Browns,13,Detroit Lions,21,0,0,0,0,0,0,-8,34,2018-08-30T18:38:39.578Z,cmaronchick,0
-12,2018,-1,New England Patriots,35,New York Giants,14,1,0,1,0,0,0,21,49,2018-08-30T18:35:26.118Z,cmaronchick,4
-5,2018,-1,Dallas Cowboys,24,Houston Texans,21,0,0,0,0,0,0,3,45,2018-08-30T22:33:28.560Z,Facebook_10154993923975769,0
-7,2018,-1,Minnesota Vikings,21,Tennessee Titans,18,1,0,1,0,0,0,3,39,2018-08-30T22:33:43.280Z,Facebook_10154993923975769,4
-4,2018,-1,Green Bay Packers,17,Kansas City Chiefs,7,0,0,0,0,0,0,10,24,2018-08-30T22:33:53.158Z,Facebook_10154993923975769,0
-3,2018,-1,Denver Broncos,21,Arizona Cardinals,14,1,0,1,0,1,0,7,35,2018-08-30T22:34:01.778Z,Facebook_10154993923975769,7
-1,2018,-1,Oakland Raiders,21,Seattle Seahawks,28,0,0,0,0,1,0,-7,49,2018-08-30T22:34:11.419Z,Facebook_10154993923975769,3
-2,2018,-1,Los Angeles Chargers,21,San Francisco 49ers,18,1,0,1,0,1,0,3,39,2018-08-30T22:34:20.478Z,Facebook_10154993923975769,6
-12,2018,-1,New England Patriots,18,New York Giants,14,1,0,1,0,1,0,4,32,2018-08-30T22:36:19.280Z,Facebook_10154993923975769,6
-13,2018,-1,Cleveland Browns,21,Detroit Lions,14,1,0,1,0,0,0,7,35,2018-08-30T22:36:30.459Z,Facebook_10154993923975769,4
-14,2018,-1,New York Jets,18,Philadelphia Eagles,14,0,0,0,0,0,0,4,32,2018-08-30T22:36:40.838Z,Facebook_10154993923975769,0
-15,2018,-1,Indianapolis Colts,7,Cincinnati Bengals,18,0,0,0,0,0,0,-11,25,2018-08-30T22:36:49.459Z,Facebook_10154993923975769,0
-16,2018,-1,Miami Dolphins,21,Atlanta Falcons,27,0,0,0,0,1,0,-6,48,2018-08-30T22:36:58.558Z,Facebook_10154993923975769,2
-9,2018,-1,Jacksonville Jaguars,18,Tampa Bay Buccaneers,21,0,0,0,0,0,0,-3,39,2018-08-30T22:37:06.918Z,Facebook_10154993923975769,0
-10,2018,-1,Washington Redskins,35,Baltimore Ravens,27,0,0,0,0,1,0,8,62,2018-08-30T22:37:19.208Z,Facebook_10154993923975769,2
-11,2018,-1,Carolina Panthers,21,Pittsburgh Steelers,14,0,0,0,0,0,0,7,35,2018-08-30T22:37:27.978Z,Facebook_10154993923975769,0
-6,2018,-1,Los Angeles Rams,21,New Orleans Saints,24,1,0,0,0,0,0,-3,45,2018-08-30T22:37:36.418Z,Facebook_10154993923975769,2
-8,2018,-1,Buffalo Bills,21,Chicago Bears,14,1,0,1,0,0,0,7,35,2018-08-30T22:37:44.839Z,Facebook_10154993923975769,4
-15,2018,-1,Indianapolis Colts,21,Cincinnati Bengals,14,1,0,1,0,1,0,7,35,2018-08-30T22:52:58.903Z,Facebook_10205896813734452,6
-16,2018,-1,Miami Dolphins,14,Atlanta Falcons,27,0,0,0,0,1,0,-13,41,2018-08-30T22:53:16.738Z,Facebook_10205896813734452,3
-9,2018,-1,Jacksonville Jaguars,10,Tampa Bay Buccaneers,24,0,0,0,0,1,0,-14,34,2018-08-30T22:53:31.680Z,Facebook_10205896813734452,2
-10,2018,-1,Washington Redskins,14,Baltimore Ravens,21,1,0,1,0,0,0,-7,35,2018-08-30T22:53:49.882Z,Facebook_10205896813734452,4
-5,2018,-1,Dallas Cowboys,17,Houston Texans,27,1,0,1,0,0,0,-10,44,2018-08-30T22:54:01.658Z,Facebook_10205896813734452,4
-6,2018,-1,Los Angeles Rams,13,New Orleans Saints,21,1,0,1,0,1,0,-8,34,2018-08-30T22:54:21.298Z,Facebook_10205896813734452,6
-11,2018,-1,Carolina Panthers,17,Pittsburgh Steelers,21,1,0,1,0,1,0,-4,38,2018-08-30T22:54:35.047Z,Facebook_10205896813734452,6
-7,2018,-1,Minnesota Vikings,14,Tennessee Titans,21,0,0,0,0,1,0,-7,35,2018-08-30T22:54:39.521Z,Facebook_10205896813734452,2
-8,2018,-1,Buffalo Bills,14,Chicago Bears,17,0,0,0,0,0,0,-3,31,2018-08-30T22:54:53.901Z,Facebook_10205896813734452,0
-4,2018,-1,Green Bay Packers,21,Kansas City Chiefs,17,0,0,0,0,0,0,4,38,2018-08-30T22:55:05.739Z,Facebook_10205896813734452,1
-3,2018,-1,Denver Broncos,21,Arizona Cardinals,27,0,0,0,0,0,0,-6,48,2018-08-30T22:55:16.821Z,Facebook_10205896813734452,1
-1,2018,-1,Oakland Raiders,14,Seattle Seahawks,17,0,0,0,0,0,0,-3,31,2018-08-30T22:55:27.059Z,Facebook_10205896813734452,0
-2,2018,-1,Los Angeles Chargers,17,San Francisco 49ers,24,0,0,0,0,1,0,-7,41,2018-08-30T22:55:45.001Z,Facebook_10205896813734452,2
-12,2018,-1,New England Patriots,13,New York Giants,19,0,0,0,0,1,0,-6,32,2018-08-28T21:06:34.444Z,cmaronchick-gmail,2
-12,2018,-1,New England Patriots,24,New York Giants,17,1,0,1,0,0,0,7,41,2018-08-30T04:22:09.100Z,Facebook_10210894378652618,4
-13,2018,-1,Cleveland Browns,6,Detroit Lions,17,0,0,0,0,0,0,-11,23,2018-08-30T22:52:31.878Z,Facebook_10205896813734452,1
-14,2018,-1,New York Jets,18,Philadelphia Eagles,24,0,0,1,0,1,0,-6,42,2018-08-30T04:22:22.443Z,Facebook_10210894378652618,4
-15,2018,-1,Indianapolis Colts,24,Cincinnati Bengals,21,1,0,1,0,1,0,3,45,2018-08-30T04:22:42.840Z,Facebook_10210894378652618,6
-14,2018,-1,New York Jets,23,Philadelphia Eagles,13,0,0,0,0,1,0,10,36,2018-08-27T17:52:10.161Z,cmaronchick-gmail,2
-14,2018,-1,New York Jets,13,Philadelphia Eagles,17,0,0,1,0,0,0,-4,30,2018-08-30T18:18:38.958Z,cmaronchick,2
-14,2018,-1,New York Jets,14,Philadelphia Eagles,27,0,0,1,0,1,0,-13,41,2018-08-30T22:52:44.658Z,Facebook_10205896813734452,4
-15,2018,-1,Indianapolis Colts,16,Cincinnati Bengals,21,0,0,0,0,1,0,-5,37,2018-08-27T19:04:15.960Z,cmaronchick-gmail,2
-15,2018,-1,Indianapolis Colts,14,Cincinnati Bengals,10,1,0,1,0,0,0,4,24,2018-08-30T18:19:09.038Z,cmaronchick,4
-9,2018,-1,Jacksonville Jaguars,19,Tampa Bay Buccaneers,12,1,0,1,0,1,0,7,31,2018-08-27T19:54:07.221Z,cmaronchick-gmail,6
-9,2018,-1,Jacksonville Jaguars,17,Tampa Bay Buccaneers,14,1,0,1,0,1,0,3,31,2018-08-30T04:25:15.481Z,Facebook_10210894378652618,6
-9,2018,-1,Jacksonville Jaguars,19,Tampa Bay Buccaneers,13,1,0,1,0,1,0,6,32,2018-08-30T18:19:32.377Z,cmaronchick,6
-16,2018,-1,Miami Dolphins,24,Atlanta Falcons,31,0,0,0,0,1,0,-7,55,2018-08-30T04:27:14.142Z,Facebook_10210894378652618,2
-16,2018,-1,Miami Dolphins,18,Atlanta Falcons,20,0,0,1,0,1,0,-2,38,2018-08-30T18:19:18.181Z,cmaronchick,4
-10,2018,-1,Washington Redskins,25,Baltimore Ravens,19,0,0,0,0,1,0,6,44,2018-08-27T19:55:38.101Z,cmaronchick-gmail,2
-10,2018,-1,Washington Redskins,11,Baltimore Ravens,24,1,0,1,0,0,0,-13,35,2018-08-30T04:25:23.780Z,Facebook_10210894378652618,4
-10,2018,-1,Washington Redskins,18,Baltimore Ravens,17,0,0,0,0,0,0,1,35,2018-08-30T18:19:42.719Z,cmaronchick,0
-5,2018,-1,Dallas Cowboys,28,Houston Texans,21,0,0,0,0,0,0,7,49,2018-08-30T04:26:13.601Z,Facebook_10210894378652618,0
-5,2018,-1,Dallas Cowboys,16,Houston Texans,21,1,0,1,0,0,0,-5,37,2018-08-30T18:20:07.757Z,cmaronchick,4
-11,2018,-1,Carolina Panthers,24,Pittsburgh Steelers,21,0,0,0,0,1,0,3,45,2018-08-28T20:27:44.405Z,cmaronchick-gmail,3
-11,2018,-1,Carolina Panthers,28,Pittsburgh Steelers,14,0,0,0,0,1,0,14,42,2018-08-30T04:26:22.282Z,Facebook_10210894378652618,2
-11,2018,-1,Carolina Panthers,24,Pittsburgh Steelers,20,0,0,0,0,1,0,4,44,2018-08-30T18:19:55.637Z,cmaronchick,3
-8,2018,-1,Buffalo Bills,21,Chicago Bears,24,0,0,0,0,1,0,-3,45,2018-08-30T04:27:39.521Z,Facebook_10210894378652618,2
-8,2018,-1,Buffalo Bills,24,Chicago Bears,10,1,0,1,0,0,0,14,34,2018-08-30T18:20:34.278Z,cmaronchick,4
-6,2018,-1,Los Angeles Rams,19,New Orleans Saints,16,0,0,0,0,1,0,3,35,2018-08-28T20:49:20.603Z,cmaronchick-gmail,2
-6,2018,-1,Los Angeles Rams,21,New Orleans Saints,28,1,0,1,0,0,0,-7,49,2018-08-30T04:28:31.622Z,Facebook_10210894378652618,5
-6,2018,-1,Los Angeles Rams,12,New Orleans Saints,18,1,0,1,0,1,0,-6,30,2018-08-30T18:20:14.562Z,cmaronchick,6
-7,2018,-1,Minnesota Vikings,17,Tennessee Titans,21,0,0,0,0,0,0,-4,38,2018-08-30T04:28:41.082Z,Facebook_10210894378652618,0
-7,2018,-1,Minnesota Vikings,27,Tennessee Titans,20,1,0,1,0,0,0,7,47,2018-08-30T18:20:24.409Z,cmaronchick,4
-4,2018,-2,Philadelphia Eagles,24,Cleveland Browns,17,0,0,0,0,1,0,7,41,2018-08-22T00:04:57.316Z,Facebook_10208710241577136,2
-4,2018,-1,Green Bay Packers,13,Kansas City Chiefs,17,1,0,0,0,0,0,-4,30,2018-08-28T20:50:09.465Z,cmaronchick-gmail,2
-4,2018,-1,Green Bay Packers,28,Kansas City Chiefs,21,0,0,0,0,1,0,7,49,2018-08-30T04:27:20.041Z,Facebook_10210894378652618,2
-4,2018,-1,Green Bay Packers,19,Kansas City Chiefs,23,1,0,0,0,1,0,-4,42,2018-08-30T18:20:43.797Z,cmaronchick,4
-2,2018,-3,Cleveland Browns,18,New York Giants,24,0,0,0,0,1,0,-6,42,2018-08-08T23:20:08.481Z,Facebook_10155298489409129,2
-2,2018,-1,Los Angeles Chargers,21,San Francisco 49ers,32,0,0,0,0,1,0,-11,53,2018-08-30T04:26:57.580Z,Facebook_10210894378652618,2
-2,2018,-1,Los Angeles Chargers,14,San Francisco 49ers,17,0,0,1,0,0,0,-3,31,2018-08-30T18:21:23.560Z,cmaronchick,2
-1,2018,-1,Oakland Raiders,21,Seattle Seahawks,32,0,0,0,0,1,0,-11,53,2018-08-30T04:21:20.203Z,Facebook_10210894378652618,2
-1,2018,-1,Oakland Raiders,6,Seattle Seahawks,20,0,0,0,0,0,0,-14,26,2018-08-30T18:21:11.782Z,cmaronchick,0
1,2018,1,Atlanta Falcons,21,Philadelphia Eagles,27,1,0,1,0,0,0,-6,48,2018-09-05T21:53:51.984Z,cmaronchick,5
9,2018,1,Tampa Bay Buccaneers,17,New Orleans Saints,24,0,0,1,0,0,0,-7,41,2018-09-01T18:49:13.746Z,cmaronchick,2
8,2018,1,Jacksonville Jaguars,20,New York Giants,17,1,0,0,0,1,0,3,37,2018-09-01T18:44:57.704Z,cmaronchick,5
7,2018,1,Houston Texans,14,New England Patriots,24,1,0,1,0,1,0,-10,38,2018-09-01T23:10:59.482Z,cmaronchick,6
6,2018,1,Buffalo Bills,13,Baltimore Ravens,27,1,0,1,0,1,0,-14,40,2018-09-01T23:11:15.780Z,cmaronchick,6
5,2018,1,San Francisco 49ers,24,Minnesota Vikings,20,0,0,0,0,1,0,4,44,2018-09-01T23:12:09.641Z,cmaronchick,2
4,2018,1,Tennessee Titans,23,Miami Dolphins,17,0,0,0,0,0,0,6,40,2018-09-01T23:12:25.741Z,cmaronchick,0
3,2018,1,Cincinnati Bengals,20,Indianapolis Colts,23,0,0,0,0,0,0,-3,43,2018-09-01T23:12:38.922Z,cmaronchick,1
2,2018,1,Pittsburgh Steelers,31,Cleveland Browns,17,0,0,0,0,1,0,14,48,2018-09-01T23:12:54.802Z,cmaronchick,2
10,2018,1,Kansas City Chiefs,17,Los Angeles Chargers,27,0,0,0,0,0,0,-10,44,2018-09-01T23:13:08.899Z,cmaronchick,0
13,2018,1,Dallas Cowboys,20,Carolina Panthers,27,1,0,1,0,0,0,-7,47,2018-09-01T23:13:21.281Z,cmaronchick,4
12,2018,1,Seattle Seahawks,24,Denver Broncos,14,0,0,0,1,0,0,10,38,2018-09-01T23:13:32.645Z,cmaronchick,1
11,2018,1,Washington Redskins,17,Arizona Cardinals,16,1,0,1,0,1,0,1,33,2018-09-01T23:14:30.561Z,cmaronchick,6
14,2018,1,Chicago Bears,14,Green Bay Packers,34,1,0,0,0,1,0,-20,48,2018-09-01T23:14:41.960Z,cmaronchick,4
15,2018,1,New York Jets,19,Detroit Lions,20,0,0,1,0,0,0,-1,39,2018-09-01T23:14:54.820Z,cmaronchick,2
16,2018,1,Los Angeles Rams,27,Oakland Raiders,20,1,0,1,0,1,0,7,47,2018-09-01T23:15:04.686Z,cmaronchick,6
9,2018,1,Tampa Bay Buccaneers,14,New Orleans Saints,24,0,0,0,0,0,0,-10,38,2018-09-07T04:27:23.032Z,Facebook_10154773754448953,0
8,2018,1,Jacksonville Jaguars,24,New York Giants,21,1,0,0,0,0,0,3,45,2018-09-02T18:00:25.642Z,Facebook_10154773754448953,2
7,2018,1,Houston Texans,14,New England Patriots,24,1,0,1,0,1,0,-10,38,2018-09-02T18:00:40.865Z,Facebook_10154773754448953,6
6,2018,1,Buffalo Bills,17,Baltimore Ravens,14,0,0,0,0,0,0,3,31,2018-09-02T18:02:22.121Z,Facebook_10154773754448953,0
5,2018,1,San Francisco 49ers,21,Minnesota Vikings,24,1,0,0,0,1,0,-3,45,2018-09-02T18:02:37.440Z,Facebook_10154773754448953,5
4,2018,1,Tennessee Titans,24,Miami Dolphins,21,0,0,0,0,1,0,3,45,2018-09-02T18:02:54.220Z,Facebook_10154773754448953,2
3,2018,1,Cincinnati Bengals,14,Indianapolis Colts,17,0,0,0,0,0,0,-3,31,2018-09-02T18:03:03.640Z,Facebook_10154773754448953,0
2,2018,1,Pittsburgh Steelers,21,Cleveland Browns,17,0,0,0,0,0,0,4,38,2018-09-02T18:03:21.902Z,Facebook_10154773754448953,1
10,2018,1,Kansas City Chiefs,21,Los Angeles Chargers,17,1,0,1,0,0,0,4,38,2018-09-02T18:03:33.539Z,Facebook_10154773754448953,4
13,2018,1,Dallas Cowboys,14,Carolina Panthers,24,1,0,1,0,1,0,-10,38,2018-09-02T18:03:44.019Z,Facebook_10154773754448953,6
12,2018,1,Seattle Seahawks,21,Denver Broncos,17,0,0,0,1,0,0,4,38,2018-09-02T18:03:58.705Z,Facebook_10154773754448953,0
11,2018,1,Washington Redskins,16,Arizona Cardinals,19,0,0,0,0,1,0,-3,35,2018-09-02T18:04:12.402Z,Facebook_10154773754448953,2
14,2018,1,Chicago Bears,14,Green Bay Packers,27,1,0,0,0,0,0,-13,41,2018-09-02T18:04:24.882Z,Facebook_10154773754448953,2
15,2018,1,New York Jets,17,Detroit Lions,20,0,0,1,0,0,0,-3,37,2018-09-02T18:04:50.001Z,Facebook_10154773754448953,2
16,2018,1,Los Angeles Rams,24,Oakland Raiders,21,1,0,0,0,1,0,3,45,2018-09-02T18:05:01.782Z,Facebook_10154773754448953,4
1,2018,1,Atlanta Falcons,20,Philadelphia Eagles,24,1,0,1,0,1,0,-4,44,2018-09-03T04:50:02.616Z,cmaronchick-hotmail,6
8,2018,1,Jacksonville Jaguars,17,New York Giants,20,0,0,0,0,1,0,-3,37,2018-09-03T06:01:50.775Z,cmaronchick-hotmail,2
7,2018,1,Houston Texans,17,New England Patriots,34,1,0,1,0,0,0,-17,51,2018-09-03T06:03:10.934Z,cmaronchick-hotmail,4
6,2018,1,Buffalo Bills,13,Baltimore Ravens,24,1,0,1,0,0,0,-11,37,2018-09-03T06:03:20.573Z,cmaronchick-hotmail,4
1,2018,1,Atlanta Falcons,21,Philadelphia Eagles,24,1,0,1,0,0,0,-3,45,2018-09-05T02:49:08.236Z,Facebook_10210894378652618,4
8,2018,1,Jacksonville Jaguars,18,New York Giants,22,0,0,0,0,1,0,-4,40,2018-09-05T02:54:26.257Z,Facebook_10210894378652618,2
7,2018,1,Houston Texans,17,New England Patriots,28,1,0,1,0,1,0,-11,45,2018-09-05T02:49:39.735Z,Facebook_10210894378652618,6
6,2018,1,Buffalo Bills,14,Baltimore Ravens,23,1,0,1,0,0,0,-9,37,2018-09-05T02:49:54.577Z,Facebook_10210894378652618,4
5,2018,1,San Francisco 49ers,17,Minnesota Vikings,24,1,0,1,0,1,0,-7,41,2018-09-05T02:50:14.656Z,Facebook_10210894378652618,7
4,2018,1,Tennessee Titans,14,Miami Dolphins,24,1,0,1,0,0,0,-10,38,2018-09-05T02:50:39.035Z,Facebook_10210894378652618,4
3,2018,1,Cincinnati Bengals,10,Indianapolis Colts,24,0,0,0,0,0,0,-14,34,2018-09-05T02:50:55.415Z,Facebook_10210894378652618,0
2,2018,1,Pittsburgh Steelers,21,Cleveland Browns,9,0,0,0,0,0,0,12,30,2018-09-05T02:51:06.997Z,Facebook_10210894378652618,1
10,2018,1,Kansas City Chiefs,24,Los Angeles Chargers,31,0,0,0,0,1,0,-7,55,2018-09-05T02:51:57.457Z,Facebook_10210894378652618,2
13,2018,1,Dallas Cowboys,21,Carolina Panthers,28,1,0,1,0,0,0,-7,49,2018-09-05T02:52:09.340Z,Facebook_10210894378652618,4
12,2018,1,Seattle Seahawks,24,Denver Broncos,21,0,0,0,1,1,0,3,45,2018-09-05T02:52:26.000Z,Facebook_10210894378652618,3
11,2018,1,Washington Redskins,14,Arizona Cardinals,24,0,0,0,0,1,0,-10,38,2018-09-05T02:52:38.109Z,Facebook_10210894378652618,2
14,2018,1,Chicago Bears,21,Green Bay Packers,27,1,0,1,0,1,0,-6,48,2018-09-05T02:53:07.615Z,Facebook_10210894378652618,6
15,2018,1,New York Jets,21,Detroit Lions,20,1,0,1,0,0,0,1,41,2018-09-05T02:53:19.676Z,Facebook_10210894378652618,4
16,2018,1,Los Angeles Rams,21,Oakland Raiders,24,0,0,0,0,1,0,-3,45,2018-09-05T02:53:36.105Z,Facebook_10210894378652618,2
9,2018,1,Tampa Bay Buccaneers,14,New Orleans Saints,24,0,0,0,0,0,0,-10,38,2018-09-05T02:54:01.836Z,Facebook_10210894378652618,0
8,2018,1,Jacksonville Jaguars,28,New York Giants,10,1,0,1,0,1,0,18,38,2018-09-05T18:18:45.437Z,Facebook_10101964290128875,6
7,2018,1,Houston Texans,14,New England Patriots,24,1,0,1,0,1,0,-10,38,2018-09-05T18:20:05.164Z,Facebook_10101964290128875,6
6,2018,1,Buffalo Bills,3,Baltimore Ravens,17,1,0,1,0,0,0,-14,20,2018-09-05T18:20:14.824Z,Facebook_10101964290128875,5
5,2018,1,San Francisco 49ers,14,Minnesota Vikings,20,1,0,0,0,1,0,-6,34,2018-09-05T18:20:49.566Z,Facebook_10101964290128875,4
4,2018,1,Tennessee Titans,10,Miami Dolphins,17,1,0,1,0,0,0,-7,27,2018-09-05T18:21:07.587Z,Facebook_10101964290128875,5
3,2018,1,Cincinnati Bengals,17,Indianapolis Colts,7,1,0,1,0,0,0,10,24,2018-09-05T18:21:20.284Z,Facebook_10101964290128875,4
2,2018,1,Pittsburgh Steelers,31,Cleveland Browns,24,0,0,0,0,1,0,7,55,2018-09-05T18:21:32.145Z,Facebook_10101964290128875,2
10,2018,1,Kansas City Chiefs,24,Los Angeles Chargers,21,1,0,1,0,0,0,3,45,2018-09-05T18:21:43.864Z,Facebook_10101964290128875,4
13,2018,1,Dallas Cowboys,10,Carolina Panthers,24,1,0,1,0,1,0,-14,34,2018-09-05T18:21:53.947Z,Facebook_10101964290128875,6
12,2018,1,Seattle Seahawks,13,Denver Broncos,17,1,0,0,1,0,0,-4,30,2018-09-05T18:22:11.505Z,Facebook_10101964290128875,2
11,2018,1,Washington Redskins,21,Arizona Cardinals,27,0,0,0,0,0,0,-6,48,2018-09-05T18:22:24.305Z,Facebook_10101964290128875,0
14,2018,1,Chicago Bears,10,Green Bay Packers,21,1,0,0,0,0,0,-11,31,2018-09-05T18:22:37.784Z,Facebook_10101964290128875,2
15,2018,1,New York Jets,7,Detroit Lions,13,0,0,1,0,0,0,-6,20,2018-09-05T18:22:45.760Z,Facebook_10101964290128875,2
16,2018,1,Los Angeles Rams,28,Oakland Raiders,31,0,0,0,0,0,0,-3,59,2018-09-05T18:23:02.644Z,Facebook_10101964290128875,0
9,2018,1,Tampa Bay Buccaneers,13,New Orleans Saints,20,0,0,1,0,0,0,-7,33,2018-09-05T18:23:13.585Z,Facebook_10101964290128875,2
8,2018,1,Jacksonville Jaguars,20,New York Giants,3,1,0,1,0,1,0,17,23,2018-09-07T01:28:47.251Z,Facebook_10213631282628797,7
1,2018,1,Atlanta Falcons,24,Philadelphia Eagles,17,0,0,0,0,1,0,7,41,2018-09-05T20:05:54.586Z,Facebook_10213631282628797,2
7,2018,1,Houston Texans,27,New England Patriots,31,1,0,0,0,0,0,-4,58,2018-09-07T01:28:44.487Z,Facebook_10213631282628797,2
6,2018,1,Buffalo Bills,10,Baltimore Ravens,17,1,0,0,0,0,0,-7,27,2018-09-07T01:28:51.748Z,Facebook_10213631282628797,2
5,2018,1,San Francisco 49ers,13,Minnesota Vikings,20,1,0,1,0,1,0,-7,33,2018-09-07T01:28:55.324Z,Facebook_10213631282628797,6
13,2018,1,Dallas Cowboys,23,Carolina Panthers,20,0,0,0,0,0,0,3,43,2018-09-05T20:19:47.606Z,cmaronchick-gmail,0
12,2018,1,Seattle Seahawks,24,Denver Broncos,16,0,0,0,1,0,0,8,40,2018-09-05T20:21:13.524Z,cmaronchick-gmail,1
14,2018,1,Chicago Bears,17,Green Bay Packers,27,1,0,0,0,0,0,-10,44,2018-09-05T20:23:08.374Z,cmaronchick-gmail,2
15,2018,1,New York Jets,17,Detroit Lions,23,0,0,1,0,0,0,-6,40,2018-09-05T20:30:04.184Z,cmaronchick-gmail,2
1,2018,1,Atlanta Falcons,18,Philadelphia Eagles,21,1,0,1,0,1,0,-3,39,2018-09-06T00:28:46.685Z,Facebook_10154993923975769,6
8,2018,1,Jacksonville Jaguars,14,New York Giants,17,0,0,0,0,1,0,-3,31,2018-09-06T00:29:03.068Z,Facebook_10154993923975769,2
7,2018,1,Houston Texans,18,New England Patriots,24,1,0,0,0,1,0,-6,42,2018-09-06T00:29:16.303Z,Facebook_10154993923975769,4
6,2018,1,Buffalo Bills,18,Baltimore Ravens,14,0,0,0,0,0,0,4,32,2018-09-06T00:29:29.187Z,Facebook_10154993923975769,0
5,2018,1,San Francisco 49ers,24,Minnesota Vikings,21,0,0,0,0,1,0,3,45,2018-09-06T00:29:47.164Z,Facebook_10154993923975769,2
4,2018,1,Tennessee Titans,7,Miami Dolphins,14,1,0,1,0,0,0,-7,21,2018-09-06T00:29:56.599Z,Facebook_10154993923975769,5
3,2018,1,Cincinnati Bengals,24,Indianapolis Colts,21,1,0,1,0,0,0,3,45,2018-09-06T00:30:10.884Z,Facebook_10154993923975769,4
2,2018,1,Pittsburgh Steelers,24,Cleveland Browns,28,0,0,1,0,1,0,-4,52,2018-09-06T00:30:22.446Z,Facebook_10154993923975769,4
10,2018,1,Kansas City Chiefs,24,Los Angeles Chargers,21,1,0,1,0,0,0,3,45,2018-09-06T00:30:37.108Z,Facebook_10154993923975769,4
13,2018,1,Dallas Cowboys,14,Carolina Panthers,18,1,0,1,0,1,0,-4,32,2018-09-06T00:30:51.226Z,Facebook_10154993923975769,6
12,2018,1,Seattle Seahawks,24,Denver Broncos,21,0,0,0,1,1,0,3,45,2018-09-06T00:31:02.725Z,Facebook_10154993923975769,3
11,2018,1,Washington Redskins,35,Arizona Cardinals,28,1,0,1,0,0,0,7,63,2018-09-06T00:31:13.448Z,Facebook_10154993923975769,4
14,2018,1,Chicago Bears,18,Green Bay Packers,24,1,0,1,0,0,0,-6,42,2018-09-06T00:31:30.126Z,Facebook_10154993923975769,5
15,2018,1,New York Jets,28,Detroit Lions,24,1,0,1,0,1,0,4,52,2018-09-06T00:31:45.424Z,Facebook_10154993923975769,6
16,2018,1,Los Angeles Rams,18,Oakland Raiders,21,0,0,0,0,1,0,-3,39,2018-09-06T00:31:58.466Z,Facebook_10154993923975769,2
9,2018,1,Tampa Bay Buccaneers,18,New Orleans Saints,21,0,0,1,0,0,0,-3,39,2018-09-06T00:32:11.766Z,Facebook_10154993923975769,2
1,2018,1,Atlanta Falcons,21,Philadelphia Eagles,20,0,0,0,0,1,0,1,41,2018-09-06T05:00:04.630Z,Facebook_10208710241577136,2
1,2018,1,Atlanta Falcons,17,Philadelphia Eagles,27,1,0,1,0,1,0,-10,44,2018-09-06T05:24:47.590Z,Facebook_10205896813734452,6
8,2018,1,Jacksonville Jaguars,23,New York Giants,17,1,0,1,0,1,0,6,40,2018-09-06T05:16:15.709Z,Facebook_10205896813734452,6
7,2018,1,Houston Texans,16,New England Patriots,27,1,0,1,0,1,0,-11,43,2018-09-06T05:17:00.510Z,Facebook_10205896813734452,7
6,2018,1,Buffalo Bills,17,Baltimore Ravens,23,1,0,0,0,1,0,-6,40,2018-09-06T05:17:45.611Z,Facebook_10205896813734452,4
5,2018,1,San Francisco 49ers,13,Minnesota Vikings,27,1,0,1,0,1,0,-14,40,2018-09-06T05:18:29.530Z,Facebook_10205896813734452,7
4,2018,1,Tennessee Titans,24,Miami Dolphins,21,0,0,0,0,1,0,3,45,2018-09-06T05:19:49.010Z,Facebook_10205896813734452,2
3,2018,1,Cincinnati Bengals,23,Indianapolis Colts,21,1,0,1,0,0,0,2,44,2018-09-06T05:20:27.608Z,Facebook_10205896813734452,4
2,2018,1,Pittsburgh Steelers,21,Cleveland Browns,17,0,0,0,0,0,0,4,38,2018-09-06T05:21:16.698Z,Facebook_10205896813734452,1
10,2018,1,Kansas City Chiefs,17,Los Angeles Chargers,23,0,0,0,0,0,0,-6,40,2018-09-06T05:21:42.292Z,Facebook_10205896813734452,0
13,2018,1,Dallas Cowboys,17,Carolina Panthers,24,1,0,1,0,1,0,-7,41,2018-09-06T05:22:01.569Z,Facebook_10205896813734452,6
12,2018,1,Seattle Seahawks,14,Denver Broncos,21,1,0,0,1,0,0,-7,35,2018-09-06T05:22:26.348Z,Facebook_10205896813734452,2
11,2018,1,Washington Redskins,27,Arizona Cardinals,17,1,0,1,0,0,0,10,44,2018-09-06T05:22:53.588Z,Facebook_10205896813734452,4
15,2018,1,New York Jets,21,Detroit Lions,14,1,0,1,0,0,0,7,35,2018-09-06T05:23:50.168Z,Facebook_10205896813734452,4
16,2018,1,Los Angeles Rams,27,Oakland Raiders,17,1,0,1,0,1,0,10,44,2018-09-06T05:24:05.491Z,Facebook_10205896813734452,6
9,2018,1,Tampa Bay Buccaneers,17,New Orleans Saints,31,0,0,0,0,0,0,-14,48,2018-09-06T05:24:38.549Z,Facebook_10205896813734452,0
1,2018,1,Atlanta Falcons,21,Philadelphia Eagles,24,1,0,1,0,0,0,-3,45,2018-09-06T05:40:33.032Z,Facebook_10154523075462819,4
8,2018,1,Jacksonville Jaguars,17,New York Giants,10,1,0,1,0,1,0,7,27,2018-09-06T05:41:05.910Z,Facebook_10154523075462819,6
7,2018,1,Houston Texans,17,New England Patriots,27,1,0,1,0,1,0,-10,44,2018-09-06T05:41:37.950Z,Facebook_10154523075462819,7
6,2018,1,Buffalo Bills,17,Baltimore Ravens,13,0,0,0,0,0,0,4,30,2018-09-06T05:42:09.250Z,Facebook_10154523075462819,0
5,2018,1,San Francisco 49ers,17,Minnesota Vikings,31,1,0,1,0,0,0,-14,48,2018-09-06T05:42:41.949Z,Facebook_10154523075462819,4
4,2018,1,Tennessee Titans,27,Miami Dolphins,24,0,0,0,0,1,0,3,51,2018-09-06T05:43:16.831Z,Facebook_10154523075462819,2
3,2018,1,Cincinnati Bengals,21,Indianapolis Colts,24,0,0,0,0,0,0,-3,45,2018-09-06T05:43:36.268Z,Facebook_10154523075462819,0
2,2018,1,Pittsburgh Steelers,27,Cleveland Browns,24,0,0,1,0,1,0,3,51,2018-09-06T05:44:07.471Z,Facebook_10154523075462819,4
10,2018,1,Kansas City Chiefs,17,Los Angeles Chargers,21,0,0,0,0,0,0,-4,38,2018-09-06T05:48:15.611Z,Facebook_10154523075462819,0
13,2018,1,Dallas Cowboys,14,Carolina Panthers,17,1,0,0,0,1,0,-3,31,2018-09-06T05:44:49.373Z,Facebook_10154523075462819,4
12,2018,1,Seattle Seahawks,24,Denver Broncos,20,0,0,0,1,1,0,4,44,2018-09-06T05:45:25.708Z,Facebook_10154523075462819,3
11,2018,1,Washington Redskins,17,Arizona Cardinals,13,1,0,1,0,1,0,4,30,2018-09-06T05:45:53.390Z,Facebook_10154523075462819,7
14,2018,1,Chicago Bears,17,Green Bay Packers,24,1,0,0,0,0,0,-7,41,2018-09-06T05:46:14.949Z,Facebook_10154523075462819,3
15,2018,1,New York Jets,17,Detroit Lions,27,0,0,0,0,0,0,-10,44,2018-09-06T05:46:58.789Z,Facebook_10154523075462819,0
16,2018,1,Los Angeles Rams,31,Oakland Raiders,17,1,0,1,0,0,0,14,48,2018-09-06T05:47:25.931Z,Facebook_10154523075462819,4
9,2018,1,Tampa Bay Buccaneers,17,New Orleans Saints,21,0,0,1,0,0,0,-4,38,2018-09-06T05:47:53.710Z,Facebook_10154523075462819,2
1,2018,1,Atlanta Falcons,17,Philadelphia Eagles,20,1,0,1,0,1,0,-3,37,2018-09-06T13:34:47.886Z,thepem,6
8,2018,1,Jacksonville Jaguars,20,New York Giants,6,1,0,1,0,1,0,14,26,2018-09-06T13:35:19.828Z,thepem,7
5,2018,1,San Francisco 49ers,10,Minnesota Vikings,17,1,0,1,0,1,0,-7,27,2018-09-06T13:36:20.706Z,thepem,6
2,2018,1,Pittsburgh Steelers,24,Cleveland Browns,10,0,0,0,0,0,0,14,34,2018-09-06T13:36:58.434Z,thepem,0
3,2018,1,Cincinnati Bengals,16,Indianapolis Colts,17,0,0,0,0,0,0,-1,33,2018-09-06T13:37:17.290Z,thepem,0
9,2018,1,Tampa Bay Buccaneers,7,New Orleans Saints,24,0,0,0,0,0,0,-17,31,2018-09-06T13:37:46.866Z,thepem,0
11,2018,1,Washington Redskins,17,Arizona Cardinals,24,0,0,0,0,1,0,-7,41,2018-09-06T13:38:47.325Z,thepem,2
10,2018,1,Kansas City Chiefs,13,Los Angeles Chargers,17,0,0,0,0,0,0,-4,30,2018-09-06T13:39:19.911Z,thepem,0
1,2018,1,Atlanta Falcons,24,Philadelphia Eagles,32,1,0,1,0,0,0,-8,56,2018-09-06T18:05:04.805Z,Facebook_10156296525208127,4
14,2018,1,Chicago Bears,18,Green Bay Packers,24,1,0,1,0,0,0,-6,42,2018-09-02T17:16:44.681Z,Facebook_10208710241577136,5
8,2018,1,Jacksonville Jaguars,10,New York Giants,7,1,0,0,0,1,0,3,17,2018-09-07T00:10:47.127Z,chrisl777,4
5,2018,1,San Francisco 49ers,13,Minnesota Vikings,17,1,0,0,0,1,0,-4,30,2018-09-07T00:16:10.906Z,chrisl777,4
3,2018,1,Cincinnati Bengals,10,Indianapolis Colts,21,0,0,0,0,0,0,-11,31,2018-09-07T00:16:36.426Z,chrisl777,0
10,2018,1,Kansas City Chiefs,14,Los Angeles Chargers,17,0,0,0,0,0,0,-3,31,2018-09-07T00:18:40.686Z,chrisl777,0
9,2018,1,Tampa Bay Buccaneers,3,New Orleans Saints,31,0,0,0,0,0,0,-28,34,2018-09-07T00:20:42.765Z,chrisl777,0
8,2018,1,Jacksonville Jaguars,31,New York Giants,14,1,0,1,0,0,0,17,45,2018-09-07T00:31:12.026Z,ineverwin,4
2,2018,1,Pittsburgh Steelers,31,Cleveland Browns,17,0,0,0,0,1,0,14,48,2018-09-07T00:51:47.404Z,Facebook_10213631282628797,2
10,2018,1,Kansas City Chiefs,13,Los Angeles Chargers,17,0,0,0,0,0,0,-4,30,2018-09-07T00:52:41.687Z,Facebook_10213631282628797,0
13,2018,1,Dallas Cowboys,24,Carolina Panthers,21,0,0,0,0,0,0,3,45,2018-09-07T00:53:05.847Z,Facebook_10213631282628797,0
12,2018,1,Seattle Seahawks,16,Denver Broncos,20,1,0,0,1,0,0,-4,36,2018-09-07T00:53:51.984Z,Facebook_10213631282628797,2
11,2018,1,Washington Redskins,24,Arizona Cardinals,17,1,0,1,0,1,0,7,41,2018-09-07T00:54:25.387Z,Facebook_10213631282628797,7
14,2018,1,Chicago Bears,21,Green Bay Packers,28,1,0,0,0,1,0,-7,49,2018-09-07T00:55:15.268Z,Facebook_10213631282628797,4
15,2018,1,New York Jets,10,Detroit Lions,24,0,0,0,0,0,0,-14,34,2018-09-07T00:56:26.764Z,Facebook_10213631282628797,0
9,2018,1,Tampa Bay Buccaneers,6,New Orleans Saints,21,0,0,0,0,0,0,-15,27,2018-09-07T01:07:12.044Z,Facebook_10213631282628797,0
16,2018,1,Los Angeles Rams,31,Oakland Raiders,17,1,0,1,0,0,0,14,48,2018-09-07T01:07:59.584Z,Facebook_10213631282628797,4
4,2018,1,Tennessee Titans,17,Miami Dolphins,14,0,0,0,0,0,0,3,31,2018-09-07T01:09:06.407Z,Facebook_10213631282628797,0
3,2018,1,Cincinnati Bengals,13,Indianapolis Colts,14,0,0,0,0,0,0,-1,27,2018-09-07T01:11:35.026Z,Facebook_10213631282628797,0
1,2018,1,Atlanta Falcons,24,Philadelphia Eagles,27,1,0,1,0,0,0,-3,51,2018-09-02T17:57:19.379Z,Facebook_10154773754448953,4
1,2018,1,Atlanta Falcons,31,Philadelphia Eagles,17,0,0,0,0,0,0,14,48,2018-09-05T18:18:33.466Z,Facebook_10101964290128875,0
1,2018,1,Atlanta Falcons,10,Philadelphia Eagles,21,1,0,1,0,1,0,-11,31,2018-09-07T00:06:05.226Z,chrisl777,6
14,2018,1,Chicago Bears,13,Green Bay Packers,21,1,0,0,0,0,0,-8,34,2018-09-07T05:54:34.073Z,Facebook_10205896813734452,2
7,2018,1,Houston Texans,20,New England Patriots,27,1,0,1,0,1,0,-7,47,2018-09-08T18:54:06.150Z,Facebook_10208710241577136,10
12,2018,1,Seattle Seahawks,17,Denver Broncos,24,1,0,0,1,0,0,-7,41,2018-09-08T18:54:54.671Z,Facebook_10208710241577136,2
11,2018,1,Washington Redskins,23,Arizona Cardinals,13,1,0,1,0,1,0,10,36,2018-09-08T18:56:05.250Z,Facebook_10208710241577136,6
15,2018,1,New York Jets,21,Detroit Lions,25,0,0,1,0,1,0,-4,46,2018-09-08T18:56:26.050Z,Facebook_10208710241577136,4
16,2018,1,Los Angeles Rams,27,Oakland Raiders,10,1,0,1,0,1,0,17,37,2018-09-08T18:56:42.390Z,Facebook_10208710241577136,6
3,2018,1,Cincinnati Bengals,17,Indianapolis Colts,23,0,0,0,0,0,0,-6,40,2018-09-09T15:45:22.390Z,davidcurtc22,1
5,2018,1,San Francisco 49ers,21,Minnesota Vikings,24,1,0,0,0,1,0,-3,45,2018-09-09T15:44:27.051Z,davidcurtc22,5
2,2018,1,Pittsburgh Steelers,31,Cleveland Browns,14,0,0,0,0,1,0,17,45,2018-09-09T15:46:50.392Z,davidcurtc22,2
7,2018,1,Houston Texans,28,New England Patriots,31,1,0,0,0,0,0,-3,59,2018-09-09T15:47:47.913Z,davidcurtc22,2
9,2018,1,Tampa Bay Buccaneers,28,New Orleans Saints,34,0,0,1,0,1,0,-6,62,2018-09-09T15:48:43.470Z,davidcurtc22,4
8,2018,1,Jacksonville Jaguars,24,New York Giants,17,1,0,1,0,1,0,7,41,2018-09-09T15:49:05.577Z,davidcurtc22,6
10,2018,1,Kansas City Chiefs,21,Los Angeles Chargers,24,0,0,0,0,0,0,-3,45,2018-09-09T15:49:57.530Z,davidcurtc22,0
11,2018,1,Washington Redskins,21,Arizona Cardinals,24,0,0,0,0,0,0,-3,45,2018-09-09T15:51:20.912Z,davidcurtc22,0
3,2018,1,Cincinnati Bengals,23,Indianapolis Colts,24,0,0,0,0,0,0,-1,47,2018-09-02T17:14:23.537Z,Facebook_10208710241577136,0
5,2018,1,San Francisco 49ers,19,Minnesota Vikings,23,1,0,0,0,1,0,-4,42,2018-09-02T17:13:31.280Z,Facebook_10208710241577136,4
7,2018,1,Houston Texans,17,New England Patriots,24,1,0,1,0,1,0,-7,41,2018-09-06T13:35:40.555Z,thepem,7
7,2018,1,Houston Texans,31,New England Patriots,14,0,0,0,0,1,0,17,45,2018-09-07T00:11:10.186Z,chrisl777,2
9,2018,1,Tampa Bay Buccaneers,17,New Orleans Saints,30,0,0,0,0,0,0,-13,47,2018-09-02T17:09:19.561Z,Facebook_10208710241577136,0
9,2018,1,Tampa Bay Buccaneers,16,New Orleans Saints,31,0,0,0,0,0,0,-15,47,2018-09-05T20:47:37.064Z,cmaronchick-gmail,0
8,2018,1,Jacksonville Jaguars,28,New York Giants,20,1,0,1,0,0,0,8,48,2018-09-02T17:09:53.960Z,Facebook_10208710241577136,4
8,2018,1,Jacksonville Jaguars,17,New York Giants,20,0,0,0,0,1,0,-3,37,2018-09-05T05:30:51.501Z,cmaronchick-gmail,2
6,2018,1,Buffalo Bills,18,Baltimore Ravens,20,1,0,0,0,0,0,-2,38,2018-09-02T17:13:06.325Z,Facebook_10208710241577136,2
6,2018,1,Buffalo Bills,17,Baltimore Ravens,10,0,0,0,0,0,0,7,27,2018-09-06T13:35:58.489Z,thepem,0
6,2018,1,Buffalo Bills,7,Baltimore Ravens,10,1,0,0,0,0,0,-3,17,2018-09-07T00:11:27.026Z,chrisl777,2
6,2018,1,Buffalo Bills,17,Baltimore Ravens,21,1,0,0,0,0,0,-4,38,2018-09-09T15:48:22.390Z,davidcurtc22,2
2,2018,1,Pittsburgh Steelers,31,Cleveland Browns,27,0,0,0,0,1,0,4,58,2018-09-02T17:14:40.605Z,Facebook_10208710241577136,2
2,2018,1,Pittsburgh Steelers,27,Cleveland Browns,10,0,0,0,0,0,0,17,37,2018-09-07T00:18:21.146Z,chrisl777,0
10,2018,1,Kansas City Chiefs,23,Los Angeles Chargers,24,0,0,1,0,0,0,-1,47,2018-09-02T17:14:55.360Z,Facebook_10208710241577136,2
10,2018,1,Kansas City Chiefs,16,Los Angeles Chargers,19,0,0,0,0,0,0,-3,35,2018-09-05T20:16:27.706Z,cmaronchick-gmail,0
13,2018,1,Dallas Cowboys,20,Carolina Panthers,24,1,0,1,0,0,0,-4,44,2018-09-02T17:15:12.559Z,Facebook_10208710241577136,4
13,2018,1,Dallas Cowboys,10,Carolina Panthers,17,1,0,1,0,1,0,-7,27,2018-09-06T13:39:03.748Z,thepem,6
13,2018,1,Dallas Cowboys,10,Carolina Panthers,21,1,0,1,0,1,0,-11,31,2018-09-07T00:18:52.104Z,chrisl777,6
13,2018,1,Dallas Cowboys,21,Carolina Panthers,24,1,0,0,0,0,0,-3,45,2018-09-09T15:50:18.733Z,davidcurtc22,2
12,2018,1,Seattle Seahawks,17,Denver Broncos,16,0,0,0,1,0,0,1,33,2018-09-06T13:38:35.750Z,thepem,0
12,2018,1,Seattle Seahawks,21,Denver Broncos,20,0,0,0,1,0,0,1,41,2018-09-07T00:19:07.864Z,chrisl777,0
12,2018,1,Seattle Seahawks,27,Denver Broncos,21,0,0,0,1,1,0,6,48,2018-09-09T15:51:04.770Z,davidcurtc22,2
11,2018,1,Washington Redskins,13,Arizona Cardinals,10,1,0,1,0,1,0,3,23,2018-09-07T00:19:24.947Z,chrisl777,6
4,2018,1,Tennessee Titans,20,Miami Dolphins,19,0,0,0,0,0,0,1,39,2018-09-02T17:14:06.699Z,Facebook_10208710241577136,1
4,2018,1,Tennessee Titans,17,Miami Dolphins,24,1,0,1,0,0,0,-7,41,2018-09-06T13:36:40.805Z,thepem,5
4,2018,1,Tennessee Titans,21,Miami Dolphins,7,0,0,0,0,0,0,14,28,2018-09-07T00:16:20.807Z,chrisl777,0
4,2018,1,Tennessee Titans,21,Miami Dolphins,17,0,0,0,0,0,0,4,38,2018-09-09T15:46:15.373Z,davidcurtc22,0
14,2018,1,Chicago Bears,10,Green Bay Packers,24,1,0,0,0,0,0,-14,34,2018-09-06T13:38:03.808Z,thepem,3
14,2018,1,Chicago Bears,21,Green Bay Packers,17,0,0,1,0,0,0,4,38,2018-09-07T00:19:37.609Z,chrisl777,2
14,2018,1,Chicago Bears,17,Green Bay Packers,30,1,0,0,0,1,0,-13,47,2018-09-09T20:55:25.284Z,davidcurtc22,5
-31,2018,-2,New York Giants,17,New York Jets,16,1,0,1,0,1,0,1,33,2018-08-24T05:36:31.505Z,cmaronchick-gmail,7
-29,2018,-2,New England Patriots,23,Carolina Panthers,29,1,0,1,0,0,0,-6,52,2018-08-24T05:25:45.285Z,cmaronchick-gmail,4
-28,2018,-2,Detroit Lions,20,Tampa Bay Buccaneers,17,1,0,1,0,0,0,3,37,2018-08-24T05:42:56.825Z,cmaronchick-gmail,5
-27,2018,-2,Seattle Seahawks,24,Minnesota Vikings,19,0,0,1,0,1,0,5,43,2018-08-24T05:18:24.444Z,cmaronchick-gmail,4
-24,2018,-2,Tennessee Titans,13,Pittsburgh Steelers,23,1,0,1,0,1,0,-10,36,2018-08-22T19:02:06.530Z,Facebook_10155298489409129,7
-7,2018,-1,Minnesota Vikings,14,Tennessee Titans,10,1,0,1,0,1,0,4,24,2018-08-28T20:49:36.724Z,cmaronchick-gmail,6
1,2018,1,Atlanta Falcons,20,Philadelphia Eagles,24,1,0,1,0,1,0,-4,44,2018-09-05T05:24:25.181Z,cmaronchick-gmail,6
7,2018,1,Houston Texans,24,New England Patriots,34,1,0,1,0,0,0,-10,58,2018-09-05T20:47:52.684Z,cmaronchick-gmail,4
11,2018,1,Washington Redskins,30,Arizona Cardinals,20,1,0,1,0,0,0,10,50,2018-09-05T20:22:31.546Z,cmaronchick-gmail,4
17,2018,2,Baltimore Ravens,24,Cincinnati Bengals,20,0,0,0,0,0,0,4,44,2018-09-12T05:35:52.764Z,Facebook_10154773754448953,0
15,2018,1,New York Jets,13,Detroit Lions,17,0,0,1,0,0,0,-4,30,2018-09-06T13:38:19.406Z,thepem,3
15,2018,1,New York Jets,21,Detroit Lions,14,1,0,1,0,0,0,7,35,2018-09-07T00:19:55.095Z,chrisl777,4
15,2018,1,New York Jets,20,Detroit Lions,27,0,0,0,0,1,0,-7,47,2018-09-09T15:52:04.171Z,davidcurtc22,2
16,2018,1,Los Angeles Rams,27,Oakland Raiders,13,1,0,1,0,1,0,14,40,2018-09-05T20:34:16.246Z,cmaronchick-gmail,7
16,2018,1,Los Angeles Rams,24,Oakland Raiders,17,1,0,1,0,1,0,7,41,2018-09-06T13:37:34.069Z,thepem,6
16,2018,1,Los Angeles Rams,28,Oakland Raiders,10,1,0,1,0,1,0,18,38,2018-09-07T00:20:31.906Z,chrisl777,6
16,2018,1,Los Angeles Rams,28,Oakland Raiders,21,1,0,1,0,0,0,7,49,2018-09-09T15:52:25.592Z,davidcurtc22,4
23,2018,2,Kansas City Chiefs,17,Pittsburgh Steelers,27,0,0,0,0,0,0,-10,44,2018-09-11T18:14:31.299Z,cmaronchick,0
19,2018,2,Cleveland Browns,13,New Orleans Saints,34,1,0,0,0,1,0,-21,47,2018-09-11T18:14:39.900Z,cmaronchick,4
18,2018,2,Minnesota Vikings,24,Green Bay Packers,27,0,0,1,0,1,0,-3,51,2018-09-11T18:14:48.119Z,cmaronchick,4
26,2018,2,Philadelphia Eagles,24,Tampa Bay Buccaneers,23,0,0,1,0,1,0,1,47,2018-09-11T18:14:59.078Z,cmaronchick,4
25,2018,2,Houston Texans,27,Tennessee Titans,10,0,0,0,0,1,0,17,37,2018-09-11T18:16:25.481Z,cmaronchick,3
21,2018,2,Los Angeles Chargers,31,Buffalo Bills,13,1,0,1,0,1,0,18,44,2018-09-11T18:20:42.478Z,cmaronchick,7
22,2018,2,Carolina Panthers,18,Atlanta Falcons,16,0,0,0,0,0,0,2,34,2018-09-11T18:20:53.328Z,cmaronchick,0
28,2018,2,Arizona Cardinals,10,Los Angeles Rams,27,1,0,1,0,1,0,-17,37,2018-09-11T18:21:15.859Z,cmaronchick,6
27,2018,2,Detroit Lions,20,San Francisco 49ers,24,1,0,1,0,0,0,-4,44,2018-09-11T18:21:37.120Z,cmaronchick,4
30,2018,2,New England Patriots,21,Jacksonville Jaguars,17,0,0,0,0,0,0,4,38,2018-09-11T18:21:46.871Z,cmaronchick,0
29,2018,2,Oakland Raiders,17,Denver Broncos,20,1,0,1,0,1,0,-3,37,2018-09-11T18:21:53.758Z,cmaronchick,7
31,2018,2,New York Giants,27,Dallas Cowboys,21,0,0,0,0,0,0,6,48,2018-09-11T18:22:05.418Z,cmaronchick,0
32,2018,2,Seattle Seahawks,24,Chicago Bears,23,0,0,0,0,0,0,1,47,2018-09-11T18:22:15.298Z,cmaronchick,0
24,2018,2,Indianapolis Colts,14,Washington Redskins,17,0,0,1,0,1,0,-3,31,2018-09-12T05:36:10.764Z,Facebook_10154773754448953,4
23,2018,2,Kansas City Chiefs,27,Pittsburgh Steelers,21,1,0,1,0,0,0,6,48,2018-09-12T05:36:58.143Z,Facebook_10154773754448953,4
19,2018,2,Cleveland Browns,17,New Orleans Saints,23,1,0,1,0,1,0,-6,40,2018-09-13T06:26:19.748Z,Facebook_10154773754448953,6
18,2018,2,Minnesota Vikings,27,Green Bay Packers,21,0,0,0,0,1,0,6,48,2018-09-12T05:37:34.224Z,Facebook_10154773754448953,2
26,2018,2,Philadelphia Eagles,35,Tampa Bay Buccaneers,14,0,0,0,0,1,0,21,49,2018-09-12T05:37:59.284Z,Facebook_10154773754448953,2
17,2018,2,Baltimore Ravens,27,Cincinnati Bengals,21,0,0,0,0,1,0,6,48,2018-09-12T18:41:18.506Z,Facebook_10208710241577136,2
24,2018,2,Indianapolis Colts,10,Washington Redskins,27,0,0,0,0,1,0,-17,37,2018-09-12T22:26:26.988Z,chrisl777,2
23,2018,2,Kansas City Chiefs,27,Pittsburgh Steelers,17,1,0,1,0,0,0,10,44,2018-09-12T22:27:04.487Z,chrisl777,4
26,2018,2,Philadelphia Eagles,21,Tampa Bay Buccaneers,27,1,0,1,0,1,0,-6,48,2018-09-12T22:28:32.167Z,chrisl777,10
30,2018,2,New England Patriots,17,Jacksonville Jaguars,20,1,0,1,0,0,0,-3,37,2018-09-12T22:32:08.566Z,chrisl777,4
24,2018,2,Indianapolis Colts,21,Washington Redskins,26,0,0,1,0,1,0,-5,47,2018-09-16T08:02:56.838Z,Facebook_10208710241577136,5
23,2018,2,Kansas City Chiefs,24,Pittsburgh Steelers,29,0,0,0,0,1,0,-5,53,2018-09-16T08:03:49.520Z,Facebook_10208710241577136,2
24,2018,2,Indianapolis Colts,17,Washington Redskins,10,1,0,1,0,1,0,7,27,2018-09-12T22:45:37.211Z,murreya,6
23,2018,2,Kansas City Chiefs,31,Pittsburgh Steelers,24,1,0,1,0,1,0,7,55,2018-09-12T22:45:50.611Z,murreya,6
26,2018,2,Philadelphia Eagles,30,Tampa Bay Buccaneers,21,0,0,0,0,1,0,9,51,2018-09-12T22:46:30.086Z,murreya,2
30,2018,2,New England Patriots,35,Jacksonville Jaguars,21,0,0,0,0,1,0,14,56,2018-09-12T22:49:52.867Z,murreya,2
19,2018,2,Cleveland Browns,23,New Orleans Saints,34,1,0,0,0,0,0,-11,57,2018-09-14T04:48:28.888Z,Facebook_10208710241577136,2
18,2018,2,Minnesota Vikings,23,Green Bay Packers,24,0,0,1,0,1,0,-1,47,2018-09-12T23:20:57.429Z,Facebook_10208710241577136,4
26,2018,2,Philadelphia Eagles,24,Tampa Bay Buccaneers,20,0,0,0,0,0,0,4,44,2018-09-16T08:05:54.938Z,Facebook_10208710241577136,0
25,2018,2,Houston Texans,21,Tennessee Titans,17,0,0,0,0,1,0,4,38,2018-09-16T08:06:24.361Z,Facebook_10208710241577136,2
21,2018,2,Los Angeles Chargers,31,Buffalo Bills,13,1,0,1,0,1,0,18,44,2018-09-16T08:06:47.780Z,Facebook_10208710241577136,7
22,2018,2,Carolina Panthers,22,Atlanta Falcons,24,1,0,0,0,1,0,-2,46,2018-09-12T23:31:06.527Z,Facebook_10208710241577136,4
20,2018,2,Miami Dolphins,23,New York Jets,24,0,0,1,0,0,0,-1,47,2018-09-12T23:31:24.268Z,Facebook_10208710241577136,2
28,2018,2,Arizona Cardinals,16,Los Angeles Rams,30,1,0,1,0,0,0,-14,46,2018-09-12T23:31:45.866Z,Facebook_10208710241577136,4
27,2018,2,Detroit Lions,24,San Francisco 49ers,23,0,0,1,0,0,0,1,47,2018-09-16T08:09:28.761Z,Facebook_10208710241577136,2
30,2018,2,New England Patriots,23,Jacksonville Jaguars,25,1,0,1,0,1,0,-2,48,2018-09-12T23:32:33.067Z,Facebook_10208710241577136,6
29,2018,2,Oakland Raiders,24,Denver Broncos,26,1,0,1,0,0,0,-2,50,2018-09-12T23:32:57.849Z,Facebook_10208710241577136,4
31,2018,2,New York Giants,18,Dallas Cowboys,24,1,0,1,0,0,0,-6,42,2018-09-12T23:33:19.586Z,Facebook_10208710241577136,4
32,2018,2,Seattle Seahawks,10,Chicago Bears,35,1,0,1,0,0,0,-25,45,2018-09-16T08:13:43.377Z,Facebook_10208710241577136,4
17,2018,2,Baltimore Ravens,24,Cincinnati Bengals,17,0,0,0,0,0,0,7,41,2018-09-13T04:18:06.829Z,Facebook_10210894378652618,0
24,2018,2,Indianapolis Colts,21,Washington Redskins,24,0,0,1,0,1,0,-3,45,2018-09-13T04:19:07.628Z,Facebook_10210894378652618,5
23,2018,2,Kansas City Chiefs,28,Pittsburgh Steelers,21,1,0,1,0,0,0,7,49,2018-09-13T04:19:42.987Z,Facebook_10210894378652618,4
19,2018,2,Cleveland Browns,17,New Orleans Saints,24,1,0,1,0,1,0,-7,41,2018-09-13T04:20:01.727Z,Facebook_10210894378652618,6
18,2018,2,Minnesota Vikings,24,Green Bay Packers,28,0,0,1,0,1,0,-4,52,2018-09-13T04:21:05.186Z,Facebook_10210894378652618,4
26,2018,2,Philadelphia Eagles,17,Tampa Bay Buccaneers,24,1,0,1,0,0,0,-7,41,2018-09-13T04:21:31.388Z,Facebook_10210894378652618,4
25,2018,2,Houston Texans,21,Tennessee Titans,24,1,0,1,0,0,0,-3,45,2018-09-13T04:22:12.767Z,Facebook_10210894378652618,5
21,2018,2,Los Angeles Chargers,28,Buffalo Bills,17,1,0,1,0,1,0,11,45,2018-09-13T04:22:41.607Z,Facebook_10210894378652618,7
22,2018,2,Carolina Panthers,27,Atlanta Falcons,21,0,0,0,0,1,0,6,48,2018-09-13T04:23:45.645Z,Facebook_10210894378652618,2
20,2018,2,Miami Dolphins,14,New York Jets,21,0,0,0,0,1,0,-7,35,2018-09-13T04:24:29.607Z,Facebook_10210894378652618,2
28,2018,2,Arizona Cardinals,21,Los Angeles Rams,28,1,0,0,0,0,0,-7,49,2018-09-13T04:25:49.569Z,Facebook_10210894378652618,2
27,2018,2,Detroit Lions,17,San Francisco 49ers,28,1,0,0,0,0,0,-11,45,2018-09-13T04:27:42.187Z,Facebook_10210894378652618,2
30,2018,2,New England Patriots,31,Jacksonville Jaguars,17,0,0,0,0,1,0,14,48,2018-09-13T04:28:45.766Z,Facebook_10210894378652618,2
32,2018,2,Seattle Seahawks,28,Chicago Bears,21,0,0,0,0,0,0,7,49,2018-09-13T04:29:05.287Z,Facebook_10210894378652618,0
29,2018,2,Oakland Raiders,24,Denver Broncos,27,1,0,1,0,0,0,-3,51,2018-09-13T04:29:56.488Z,Facebook_10210894378652618,4
31,2018,2,New York Giants,21,Dallas Cowboys,24,1,0,0,0,0,0,-3,45,2018-09-13T04:31:08.148Z,Facebook_10210894378652618,2
25,2018,2,Houston Texans,24,Tennessee Titans,20,0,0,0,0,0,0,4,44,2018-09-13T06:27:16.489Z,Facebook_10154773754448953,1
21,2018,2,Los Angeles Chargers,27,Buffalo Bills,10,1,0,1,0,0,0,17,37,2018-09-13T06:27:34.328Z,Facebook_10154773754448953,4
22,2018,2,Carolina Panthers,21,Atlanta Falcons,27,1,0,1,0,1,0,-6,48,2018-09-13T06:27:59.947Z,Facebook_10154773754448953,6
20,2018,2,Miami Dolphins,20,New York Jets,24,0,0,0,0,0,0,-4,44,2018-09-13T06:28:32.627Z,Facebook_10154773754448953,1
28,2018,2,Arizona Cardinals,14,Los Angeles Rams,35,1,0,1,0,0,0,-21,49,2018-09-13T06:28:47.387Z,Facebook_10154773754448953,4
27,2018,2,Detroit Lions,18,San Francisco 49ers,24,1,0,0,0,0,0,-6,42,2018-09-13T06:29:12.586Z,Facebook_10154773754448953,2
30,2018,2,New England Patriots,21,Jacksonville Jaguars,17,0,0,0,0,0,0,4,38,2018-09-13T06:29:26.926Z,Facebook_10154773754448953,0
29,2018,2,Oakland Raiders,21,Denver Broncos,17,0,0,1,0,1,0,4,38,2018-09-13T06:29:42.726Z,Facebook_10154773754448953,4
31,2018,2,New York Giants,20,Dallas Cowboys,21,1,0,0,0,1,0,-1,41,2018-09-13T06:29:57.128Z,Facebook_10154773754448953,4
32,2018,2,Seattle Seahawks,21,Chicago Bears,24,1,0,0,0,0,0,-3,45,2018-09-13T06:30:11.110Z,Facebook_10154773754448953,3
17,2018,2,Baltimore Ravens,14,Cincinnati Bengals,21,1,0,1,0,0,0,-7,35,2018-09-13T16:27:24.308Z,Facebook_10154993923975769,4
24,2018,2,Indianapolis Colts,18,Washington Redskins,14,1,0,1,0,1,0,4,32,2018-09-13T16:27:35.529Z,Facebook_10154993923975769,6
23,2018,2,Kansas City Chiefs,14,Pittsburgh Steelers,24,0,0,0,0,0,0,-10,38,2018-09-13T16:27:47.173Z,Facebook_10154993923975769,0
19,2018,2,Cleveland Browns,21,New Orleans Saints,24,1,0,1,0,1,0,-3,45,2018-09-13T16:27:59.175Z,Facebook_10154993923975769,7
18,2018,2,Minnesota Vikings,24,Green Bay Packers,28,0,0,1,0,1,0,-4,52,2018-09-13T16:28:08.229Z,Facebook_10154993923975769,4
26,2018,2,Philadelphia Eagles,18,Tampa Bay Buccaneers,14,0,0,0,0,0,0,4,32,2018-09-13T16:28:18.969Z,Facebook_10154993923975769,0
25,2018,2,Houston Texans,28,Tennessee Titans,24,0,0,0,0,0,0,4,52,2018-09-13T16:28:30.013Z,Facebook_10154993923975769,0
21,2018,2,Los Angeles Chargers,32,Buffalo Bills,28,1,0,0,0,1,0,4,60,2018-09-13T16:28:41.715Z,Facebook_10154993923975769,4
22,2018,2,Carolina Panthers,27,Atlanta Falcons,18,0,0,0,0,1,0,9,45,2018-09-13T16:28:51.192Z,Facebook_10154993923975769,2
20,2018,2,Miami Dolphins,14,New York Jets,7,1,0,1,0,1,0,7,21,2018-09-13T16:29:00.593Z,Facebook_10154993923975769,6
28,2018,2,Arizona Cardinals,21,Los Angeles Rams,28,1,0,0,0,0,0,-7,49,2018-09-13T16:29:12.170Z,Facebook_10154993923975769,2
27,2018,2,Detroit Lions,21,San Francisco 49ers,18,0,0,1,0,0,0,3,39,2018-09-13T16:29:22.569Z,Facebook_10154993923975769,2
30,2018,2,New England Patriots,28,Jacksonville Jaguars,24,0,0,0,0,1,0,4,52,2018-09-13T16:29:34.651Z,Facebook_10154993923975769,2
29,2018,2,Oakland Raiders,18,Denver Broncos,14,0,0,1,0,1,0,4,32,2018-09-13T16:29:45.009Z,Facebook_10154993923975769,4
31,2018,2,New York Giants,21,Dallas Cowboys,28,1,0,1,0,0,0,-7,49,2018-09-13T16:29:54.389Z,Facebook_10154993923975769,5
32,2018,2,Seattle Seahawks,28,Chicago Bears,24,0,0,0,0,0,0,4,52,2018-09-13T16:30:07.450Z,Facebook_10154993923975769,1
24,2018,2,Indianapolis Colts,21,Washington Redskins,17,1,0,1,0,1,0,4,38,2018-09-13T18:59:51.110Z,thepem,7
26,2018,2,Philadelphia Eagles,27,Tampa Bay Buccaneers,10,0,0,0,0,0,0,17,37,2018-09-13T19:01:20.358Z,thepem,0
17,2018,2,Baltimore Ravens,24,Cincinnati Bengals,21,0,0,0,0,1,0,3,45,2018-09-13T20:01:02.609Z,Facebook_10213631282628797,2
17,2018,2,Baltimore Ravens,27,Cincinnati Bengals,17,0,0,0,0,0,0,10,44,2018-09-13T20:49:20.209Z,Facebook_10205896813734452,0
24,2018,2,Indianapolis Colts,24,Washington Redskins,31,0,0,0,0,0,0,-7,55,2018-09-13T21:37:44.366Z,eddiefeeley,0
23,2018,2,Kansas City Chiefs,24,Pittsburgh Steelers,17,1,0,1,0,0,0,7,41,2018-09-13T21:38:06.584Z,eddiefeeley,4
19,2018,2,Cleveland Browns,14,New Orleans Saints,28,1,0,0,0,1,0,-14,42,2018-09-13T21:38:19.706Z,eddiefeeley,4
18,2018,2,Minnesota Vikings,24,Green Bay Packers,17,0,0,0,0,0,0,7,41,2018-09-13T21:38:47.365Z,eddiefeeley,0
26,2018,2,Philadelphia Eagles,24,Tampa Bay Buccaneers,9,0,0,0,0,0,0,15,33,2018-09-13T21:39:11.544Z,eddiefeeley,0
21,2018,2,Los Angeles Chargers,31,Buffalo Bills,10,1,0,1,0,0,0,21,41,2018-09-13T21:39:44.465Z,eddiefeeley,5
28,2018,2,Arizona Cardinals,10,Los Angeles Rams,28,1,0,1,0,1,0,-18,38,2018-09-13T21:40:35.865Z,eddiefeeley,6
27,2018,2,Detroit Lions,17,San Francisco 49ers,21,1,0,1,0,0,0,-4,38,2018-09-13T21:40:46.024Z,eddiefeeley,4
30,2018,2,New England Patriots,24,Jacksonville Jaguars,21,0,0,0,0,1,0,3,45,2018-09-13T21:41:02.346Z,eddiefeeley,2
17,2018,2,Baltimore Ravens,22,Cincinnati Bengals,21,0,0,0,0,0,0,1,43,2018-09-13T23:36:59.966Z,psmeyerlaw,0
23,2018,2,Kansas City Chiefs,24,Pittsburgh Steelers,29,0,0,0,0,1,0,-5,53,2018-09-13T23:37:51.206Z,psmeyerlaw,2
19,2018,2,Cleveland Browns,19,New Orleans Saints,29,1,0,0,0,1,0,-10,48,2018-09-13T23:37:52.745Z,psmeyerlaw,4
26,2018,2,Philadelphia Eagles,23,Tampa Bay Buccaneers,20,0,0,0,0,0,0,3,43,2018-09-13T23:38:26.606Z,psmeyerlaw,0
24,2018,2,Indianapolis Colts,21,Washington Redskins,27,0,0,0,0,0,0,-6,48,2018-09-13T23:39:04.025Z,psmeyerlaw,1
21,2018,2,Los Angeles Chargers,25,Buffalo Bills,17,1,0,1,0,1,0,8,42,2018-09-13T23:39:11.048Z,psmeyerlaw,6
30,2018,2,New England Patriots,23,Jacksonville Jaguars,23,0,0,1,0,1,0,0,46,2018-09-13T23:40:47.044Z,psmeyerlaw,4
17,2018,2,Baltimore Ravens,27,Cincinnati Bengals,13,0,0,0,0,0,0,14,40,2018-09-11T18:11:12.120Z,cmaronchick,0
17,2018,2,Baltimore Ravens,21,Cincinnati Bengals,17,0,0,0,0,0,0,4,38,2018-09-12T22:26:03.568Z,chrisl777,0
17,2018,2,Baltimore Ravens,24,Cincinnati Bengals,17,0,0,0,0,0,0,7,41,2018-09-12T22:45:17.048Z,murreya,0
17,2018,2,Baltimore Ravens,17,Cincinnati Bengals,10,0,0,0,0,0,0,7,27,2018-09-13T18:59:28.311Z,thepem,0
17,2018,2,Baltimore Ravens,17,Cincinnati Bengals,6,0,0,0,0,0,0,11,23,2018-09-13T21:37:20.626Z,eddiefeeley,0
25,2018,2,Houston Texans,28,Tennessee Titans,10,0,0,0,0,1,0,18,38,2018-09-13T21:39:27.686Z,eddiefeeley,2
24,2018,2,Indianapolis Colts,17,Washington Redskins,14,1,0,1,0,1,0,3,31,2018-09-14T19:32:22.728Z,Facebook_10101964290128875,6
23,2018,2,Kansas City Chiefs,24,Pittsburgh Steelers,20,1,0,1,0,0,0,4,44,2018-09-14T19:32:35.046Z,Facebook_10101964290128875,4
19,2018,2,Cleveland Browns,24,New Orleans Saints,31,1,0,1,0,0,0,-7,55,2018-09-14T19:32:50.331Z,Facebook_10101964290128875,4
18,2018,2,Minnesota Vikings,17,Green Bay Packers,21,0,0,1,0,0,0,-4,38,2018-09-14T19:33:01.887Z,Facebook_10101964290128875,2
26,2018,2,Philadelphia Eagles,28,Tampa Bay Buccaneers,17,0,0,0,0,0,0,11,45,2018-09-14T19:33:24.249Z,Facebook_10101964290128875,0
25,2018,2,Houston Texans,17,Tennessee Titans,10,0,0,0,0,1,0,7,27,2018-09-14T19:33:34.274Z,Facebook_10101964290128875,3
21,2018,2,Los Angeles Chargers,31,Buffalo Bills,7,1,0,1,0,0,0,24,38,2018-09-14T19:33:46.145Z,Facebook_10101964290128875,5
22,2018,2,Carolina Panthers,21,Atlanta Falcons,24,1,0,0,0,1,0,-3,45,2018-09-14T19:34:06.827Z,Facebook_10101964290128875,4
20,2018,2,Miami Dolphins,13,New York Jets,20,0,0,0,0,1,0,-7,33,2018-09-14T19:34:30.591Z,Facebook_10101964290128875,2
28,2018,2,Arizona Cardinals,10,Los Angeles Rams,20,1,0,0,0,1,0,-10,30,2018-09-14T19:34:47.486Z,Facebook_10101964290128875,4
27,2018,2,Detroit Lions,14,San Francisco 49ers,28,1,0,0,0,0,0,-14,42,2018-09-14T19:35:04.668Z,Facebook_10101964290128875,2
30,2018,2,New England Patriots,24,Jacksonville Jaguars,17,0,0,0,0,0,0,7,41,2018-09-14T19:35:20.886Z,Facebook_10101964290128875,0
29,2018,2,Oakland Raiders,13,Denver Broncos,17,1,0,1,0,1,0,-4,30,2018-09-14T19:35:32.206Z,Facebook_10101964290128875,6
31,2018,2,New York Giants,10,Dallas Cowboys,14,1,0,1,0,1,0,-4,24,2018-09-14T19:35:44.507Z,Facebook_10101964290128875,6
32,2018,2,Seattle Seahawks,17,Chicago Bears,21,1,0,1,0,1,0,-4,38,2018-09-14T19:36:11.488Z,Facebook_10101964290128875,7
24,2018,2,Indianapolis Colts,17,Washington Redskins,27,0,0,0,0,1,0,-10,44,2018-09-16T05:38:46.859Z,Facebook_10205896813734452,2
25,2018,2,Houston Texans,27,Tennessee Titans,21,0,0,0,0,0,0,6,48,2018-09-16T05:39:06.354Z,Facebook_10205896813734452,0
22,2018,2,Carolina Panthers,17,Atlanta Falcons,24,1,0,1,0,0,0,-7,41,2018-09-16T05:39:18.617Z,Facebook_10205896813734452,5
23,2018,2,Kansas City Chiefs,21,Pittsburgh Steelers,33,0,0,0,0,1,0,-12,54,2018-09-16T05:40:37.579Z,Facebook_10205896813734452,2
20,2018,2,Miami Dolphins,13,New York Jets,21,0,0,0,0,1,0,-8,34,2018-09-16T05:42:17.481Z,Facebook_10205896813734452,2
18,2018,2,Minnesota Vikings,27,Green Bay Packers,17,0,0,0,0,0,0,10,44,2018-09-16T05:42:44.858Z,Facebook_10205896813734452,0
26,2018,2,Philadelphia Eagles,17,Tampa Bay Buccaneers,14,0,0,0,0,0,0,3,31,2018-09-16T05:42:58.540Z,Facebook_10205896813734452,0
19,2018,2,Cleveland Browns,21,New Orleans Saints,31,1,0,0,0,0,0,-10,52,2018-09-16T05:43:33.898Z,Facebook_10205896813734452,2
27,2018,2,Detroit Lions,14,San Francisco 49ers,21,1,0,0,0,0,0,-7,35,2018-09-16T05:43:51.178Z,Facebook_10205896813734452,2
28,2018,2,Arizona Cardinals,17,Los Angeles Rams,24,1,0,0,0,1,0,-7,41,2018-09-16T05:44:55.877Z,Facebook_10205896813734452,4
21,2018,2,Los Angeles Chargers,34,Buffalo Bills,24,1,0,1,0,1,0,10,58,2018-09-16T05:45:23.620Z,Facebook_10205896813734452,6
29,2018,2,Oakland Raiders,21,Denver Broncos,28,1,0,0,0,0,0,-7,49,2018-09-16T05:46:14.479Z,Facebook_10205896813734452,2
30,2018,2,New England Patriots,21,Jacksonville Jaguars,24,1,0,1,0,1,0,-3,45,2018-09-16T05:46:29.121Z,Facebook_10205896813734452,6
31,2018,2,New York Giants,17,Dallas Cowboys,21,1,0,1,0,1,0,-4,38,2018-09-16T05:49:54.579Z,Facebook_10205896813734452,6
32,2018,2,Seattle Seahawks,34,Chicago Bears,24,0,0,0,0,0,0,10,58,2018-09-16T05:50:14.899Z,Facebook_10205896813734452,1
24,2018,2,Indianapolis Colts,20,Washington Redskins,17,1,0,1,0,1,0,3,37,2018-09-16T06:46:13.400Z,Facebook_10154523075462819,6
23,2018,2,Kansas City Chiefs,31,Pittsburgh Steelers,24,1,0,1,0,1,0,7,55,2018-09-16T06:46:35.499Z,Facebook_10154523075462819,6
19,2018,2,Cleveland Browns,17,New Orleans Saints,24,1,0,1,0,1,0,-7,41,2018-09-16T06:46:51.618Z,Facebook_10154523075462819,6
18,2018,2,Minnesota Vikings,27,Green Bay Packers,21,0,0,0,0,1,0,6,48,2018-09-16T06:47:15.439Z,Facebook_10154523075462819,2
26,2018,2,Philadelphia Eagles,27,Tampa Bay Buccaneers,22,0,0,0,0,1,0,5,49,2018-09-16T06:47:59.537Z,Facebook_10154523075462819,2
25,2018,2,Houston Texans,21,Tennessee Titans,17,0,0,0,0,1,0,4,38,2018-09-16T06:48:45.213Z,Facebook_10154523075462819,2
21,2018,2,Los Angeles Chargers,27,Buffalo Bills,24,1,0,0,0,1,0,3,51,2018-09-16T06:49:14.839Z,Facebook_10154523075462819,5
22,2018,2,Carolina Panthers,24,Atlanta Falcons,27,1,0,0,0,1,0,-3,51,2018-09-16T06:49:53.119Z,Facebook_10154523075462819,5
20,2018,2,Miami Dolphins,21,New York Jets,31,0,0,0,0,0,0,-10,52,2018-09-16T06:50:10.442Z,Facebook_10154523075462819,0
28,2018,2,Arizona Cardinals,10,Los Angeles Rams,24,1,0,1,0,1,0,-14,34,2018-09-16T06:50:38.640Z,Facebook_10154523075462819,7
27,2018,2,Detroit Lions,21,San Francisco 49ers,20,0,0,1,0,0,0,1,41,2018-09-16T06:50:54.418Z,Facebook_10154523075462819,2
30,2018,2,New England Patriots,24,Jacksonville Jaguars,17,0,0,0,0,0,0,7,41,2018-09-16T06:51:20.898Z,Facebook_10154523075462819,0
29,2018,2,Oakland Raiders,17,Denver Broncos,23,1,0,1,0,1,0,-6,40,2018-09-16T06:51:47.941Z,Facebook_10154523075462819,6
31,2018,2,New York Giants,21,Dallas Cowboys,24,1,0,0,0,0,0,-3,45,2018-09-16T06:52:15.258Z,Facebook_10154523075462819,2
32,2018,2,Seattle Seahawks,20,Chicago Bears,21,1,0,0,0,1,0,-1,41,2018-09-16T06:52:29.780Z,Facebook_10154523075462819,5
19,2018,2,Cleveland Browns,10,New Orleans Saints,35,1,0,0,0,1,0,-25,45,2018-09-12T22:27:32.128Z,chrisl777,4
19,2018,2,Cleveland Browns,17,New Orleans Saints,35,1,0,0,0,0,0,-18,52,2018-09-12T22:46:03.853Z,murreya,2
19,2018,2,Cleveland Browns,10,New Orleans Saints,24,1,0,0,0,1,0,-14,34,2018-09-13T19:00:18.269Z,thepem,4
25,2018,2,Houston Texans,21,Tennessee Titans,10,0,0,0,0,1,0,11,31,2018-09-12T22:29:03.128Z,chrisl777,2
25,2018,2,Houston Texans,14,Tennessee Titans,10,0,0,0,0,1,0,4,24,2018-09-12T22:46:41.847Z,murreya,2
25,2018,2,Houston Texans,23,Tennessee Titans,21,0,0,1,0,0,0,2,44,2018-09-13T23:39:10.285Z,psmeyerlaw,2
18,2018,2,Minnesota Vikings,17,Green Bay Packers,16,0,0,1,0,0,0,1,33,2018-09-12T22:28:01.389Z,chrisl777,2
18,2018,2,Minnesota Vikings,24,Green Bay Packers,21,0,0,0,0,0,0,3,45,2018-09-12T22:46:15.407Z,murreya,0
18,2018,2,Minnesota Vikings,14,Green Bay Packers,17,0,0,1,0,0,0,-3,31,2018-09-13T19:01:07.270Z,thepem,2
18,2018,2,Minnesota Vikings,22,Green Bay Packers,24,0,0,1,0,1,0,-2,46,2018-09-13T23:38:26.318Z,psmeyerlaw,4
21,2018,2,Los Angeles Chargers,33,Buffalo Bills,14,1,0,1,0,1,0,19,47,2018-09-12T22:29:19.768Z,chrisl777,6
21,2018,2,Los Angeles Chargers,35,Buffalo Bills,14,1,0,1,0,1,0,21,49,2018-09-12T22:46:51.067Z,murreya,6
20,2018,2,Miami Dolphins,18,New York Jets,20,0,0,1,0,1,0,-2,38,2018-09-16T16:38:10.847Z,cmaronchick,4
20,2018,2,Miami Dolphins,31,New York Jets,17,1,0,1,0,0,0,14,48,2018-09-12T22:30:41.129Z,chrisl777,4
20,2018,2,Miami Dolphins,17,New York Jets,14,1,0,1,0,1,0,3,31,2018-09-12T22:47:12.566Z,murreya,6
20,2018,2,Miami Dolphins,17,New York Jets,14,1,0,1,0,1,0,3,31,2018-09-13T21:40:22.185Z,eddiefeeley,6
20,2018,2,Miami Dolphins,20,New York Jets,23,0,0,0,0,0,0,-3,43,2018-09-13T23:39:58.665Z,psmeyerlaw,1
23,2018,2,Kansas City Chiefs,30,Pittsburgh Steelers,17,1,0,1,0,0,0,13,47,2018-09-13T19:00:09.430Z,thepem,4
24,2018,2,Indianapolis Colts,17,Washington Redskins,24,0,0,0,0,1,0,-7,41,2018-09-16T15:43:48.887Z,cmaronchick,2
22,2018,2,Carolina Panthers,17,Atlanta Falcons,14,0,0,0,0,0,0,3,31,2018-09-12T22:30:17.808Z,chrisl777,0
22,2018,2,Carolina Panthers,20,Atlanta Falcons,24,1,0,0,0,1,0,-4,44,2018-09-12T22:47:04.773Z,murreya,4
22,2018,2,Carolina Panthers,20,Atlanta Falcons,14,0,0,0,0,0,0,6,34,2018-09-13T21:40:10.765Z,eddiefeeley,0
22,2018,2,Carolina Panthers,19,Atlanta Falcons,25,1,0,1,0,1,0,-6,44,2018-09-13T23:39:58.166Z,psmeyerlaw,6
29,2018,2,Oakland Raiders,7,Denver Broncos,21,1,0,0,0,1,0,-14,28,2018-09-12T22:33:28.806Z,chrisl777,4
29,2018,2,Oakland Raiders,16,Denver Broncos,21,1,0,1,0,1,0,-5,37,2018-09-12T22:53:24.408Z,murreya,6
29,2018,2,Oakland Raiders,10,Denver Broncos,24,1,0,0,0,1,0,-14,34,2018-09-13T21:41:14.088Z,eddiefeeley,4
29,2018,2,Oakland Raiders,20,Denver Broncos,26,1,0,1,0,0,0,-6,46,2018-09-13T23:41:20.244Z,psmeyerlaw,4
27,2018,2,Detroit Lions,21,San Francisco 49ers,20,0,0,1,0,0,0,1,41,2018-09-12T22:31:45.347Z,chrisl777,2
27,2018,2,Detroit Lions,20,San Francisco 49ers,17,0,0,1,0,0,0,3,37,2018-09-12T22:47:48.089Z,murreya,2
27,2018,2,Detroit Lions,21,San Francisco 49ers,27,1,0,0,0,0,0,-6,48,2018-09-13T23:40:27.166Z,psmeyerlaw,2
28,2018,2,Arizona Cardinals,7,Los Angeles Rams,27,1,0,1,0,1,0,-20,34,2018-09-12T22:31:14.669Z,chrisl777,7
28,2018,2,Arizona Cardinals,10,Los Angeles Rams,27,1,0,1,0,1,0,-17,37,2018-09-12T22:47:33.786Z,murreya,6
28,2018,2,Arizona Cardinals,15,Los Angeles Rams,29,1,0,1,0,0,0,-14,44,2018-09-13T23:40:26.245Z,psmeyerlaw,4
31,2018,2,New York Giants,17,Dallas Cowboys,14,0,0,0,0,1,0,3,31,2018-09-12T22:33:51.069Z,chrisl777,2
31,2018,2,New York Giants,20,Dallas Cowboys,21,1,0,0,0,1,0,-1,41,2018-09-12T22:53:49.809Z,murreya,4
31,2018,2,New York Giants,20,Dallas Cowboys,12,0,0,0,0,1,0,8,32,2018-09-13T21:41:36.635Z,eddiefeeley,2
31,2018,2,New York Giants,19,Dallas Cowboys,22,1,0,0,0,1,0,-3,41,2018-09-13T23:41:58.965Z,psmeyerlaw,4
32,2018,2,Seattle Seahawks,21,Chicago Bears,17,0,0,0,0,1,0,4,38,2018-09-12T22:34:06.826Z,chrisl777,2
32,2018,2,Seattle Seahawks,24,Chicago Bears,14,0,0,0,0,1,0,10,38,2018-09-12T22:53:57.189Z,murreya,2
32,2018,2,Seattle Seahawks,20,Chicago Bears,24,1,0,1,0,0,0,-4,44,2018-09-13T21:41:48.604Z,eddiefeeley,5
33,2018,3,New York Jets,20,Cleveland Browns,23,1,0,0,0,0,0,-3,43,2018-09-18T22:07:13.207Z,Facebook_10208710241577136,2
40,2018,3,Green Bay Packers,24,Washington Redskins,17,0,0,0,0,0,0,7,41,2018-09-18T22:08:00.265Z,Facebook_10208710241577136,0
38,2018,3,New Orleans Saints,29,Atlanta Falcons,31,0,0,0,0,1,0,-2,60,2018-09-20T06:05:40.771Z,Facebook_10208710241577136,2
42,2018,3,Oakland Raiders,20,Miami Dolphins,24,1,0,1,0,0,0,-4,44,2018-09-23T06:55:42.356Z,Facebook_10208710241577136,5
46,2018,3,Dallas Cowboys,20,Seattle Seahawks,17,0,0,0,0,1,0,3,37,2018-09-23T07:02:21.914Z,Facebook_10208710241577136,3
48,2018,3,Pittsburgh Steelers,31,Tampa Bay Buccaneers,29,1,0,1,0,1,0,2,60,2018-09-23T07:02:57.054Z,Facebook_10208710241577136,6
47,2018,3,New England Patriots,33,Detroit Lions,17,0,0,0,0,1,0,16,50,2018-09-18T22:11:06.067Z,Facebook_10208710241577136,2
45,2018,3,Chicago Bears,20,Arizona Cardinals,17,1,0,1,0,1,0,3,37,2018-09-23T06:59:41.676Z,Facebook_10208710241577136,6
44,2018,3,Los Angeles Chargers,21,Los Angeles Rams,29,1,0,1,0,1,0,-8,50,2018-09-23T06:59:08.835Z,Facebook_10208710241577136,6
34,2018,3,Cincinnati Bengals,24,Carolina Panthers,28,1,0,1,0,1,0,-4,52,2018-09-23T06:58:43.855Z,Facebook_10208710241577136,7
36,2018,3,Tennessee Titans,13,Jacksonville Jaguars,23,0,0,0,0,1,0,-10,36,2018-09-18T22:13:05.006Z,Facebook_10208710241577136,2
43,2018,3,Buffalo Bills,14,Minnesota Vikings,26,0,0,1,0,1,0,-12,40,2018-09-23T06:57:25.255Z,Facebook_10208710241577136,4
39,2018,3,San Francisco 49ers,20,Kansas City Chiefs,30,1,0,1,0,0,0,-10,50,2018-09-18T22:13:41.319Z,Facebook_10208710241577136,4
41,2018,3,Indianapolis Colts,21,Philadelphia Eagles,24,1,0,1,0,1,0,-3,45,2018-09-18T22:14:03.205Z,Facebook_10208710241577136,6
35,2018,3,New York Giants,17,Houston Texans,20,0,0,1,0,0,0,-3,37,2018-09-18T22:14:24.385Z,Facebook_10208710241577136,2
37,2018,3,Denver Broncos,20,Baltimore Ravens,24,1,0,0,0,1,0,-4,44,2018-09-20T06:08:05.174Z,Facebook_10208710241577136,4
40,2018,3,Green Bay Packers,24,Washington Redskins,21,0,0,0,0,0,0,3,45,2018-09-19T03:49:21.086Z,psmeyerlaw,0
41,2018,3,Indianapolis Colts,20,Philadelphia Eagles,26,1,0,1,0,0,0,-6,46,2018-09-19T03:50:57.719Z,psmeyerlaw,4
39,2018,3,San Francisco 49ers,24,Kansas City Chiefs,31,1,0,1,0,1,0,-7,55,2018-09-19T03:51:16.866Z,psmeyerlaw,6
36,2018,3,Tennessee Titans,16,Jacksonville Jaguars,23,0,0,1,0,1,0,-7,39,2018-09-19T03:51:31.386Z,psmeyerlaw,4
34,2018,3,Cincinnati Bengals,20,Carolina Panthers,23,1,0,1,0,0,0,-3,43,2018-09-19T03:55:58.747Z,psmeyerlaw,4
44,2018,3,Los Angeles Chargers,20,Los Angeles Rams,27,1,0,0,0,0,0,-7,47,2018-09-19T03:56:17.247Z,psmeyerlaw,2
48,2018,3,Pittsburgh Steelers,27,Tampa Bay Buccaneers,26,1,0,1,0,0,0,1,53,2018-09-19T03:57:33.525Z,psmeyerlaw,4
33,2018,3,New York Jets,17,Cleveland Browns,10,0,0,0,0,1,0,7,27,2018-09-19T20:11:20.679Z,Facebook_10101964290128875,3
40,2018,3,Green Bay Packers,21,Washington Redskins,24,1,0,1,0,0,0,-3,45,2018-09-19T20:11:46.558Z,Facebook_10101964290128875,4
42,2018,3,Oakland Raiders,13,Miami Dolphins,20,1,0,1,0,0,0,-7,33,2018-09-19T20:12:07.456Z,Facebook_10101964290128875,4
38,2018,3,New Orleans Saints,24,Atlanta Falcons,27,0,0,0,0,0,0,-3,51,2018-09-19T20:12:20.417Z,Facebook_10101964290128875,0
37,2018,3,Denver Broncos,10,Baltimore Ravens,20,1,0,1,0,1,0,-10,30,2018-09-19T20:12:35.957Z,Facebook_10101964290128875,6
35,2018,3,New York Giants,7,Houston Texans,21,0,0,0,0,0,0,-14,28,2018-09-19T20:12:47.276Z,Facebook_10101964290128875,0
41,2018,3,Indianapolis Colts,13,Philadelphia Eagles,28,1,0,0,0,1,0,-15,41,2018-09-19T20:13:00.896Z,Facebook_10101964290128875,4
39,2018,3,San Francisco 49ers,17,Kansas City Chiefs,35,1,0,1,0,0,0,-18,52,2018-09-19T20:13:18.936Z,Facebook_10101964290128875,4
36,2018,3,Tennessee Titans,21,Jacksonville Jaguars,28,0,0,1,0,0,0,-7,49,2018-09-19T20:13:33.137Z,Facebook_10101964290128875,2
43,2018,3,Buffalo Bills,10,Minnesota Vikings,21,0,0,1,0,1,0,-11,31,2018-09-19T20:13:43.157Z,Facebook_10101964290128875,4
34,2018,3,Cincinnati Bengals,17,Carolina Panthers,27,1,0,1,0,0,0,-10,44,2018-09-19T20:13:56.496Z,Facebook_10101964290128875,5
44,2018,3,Los Angeles Chargers,20,Los Angeles Rams,24,1,0,0,0,0,0,-4,44,2018-09-19T20:14:09.476Z,Facebook_10101964290128875,2
45,2018,3,Chicago Bears,17,Arizona Cardinals,20,0,0,1,0,1,0,-3,37,2018-09-19T20:14:29.199Z,Facebook_10101964290128875,4
46,2018,3,Dallas Cowboys,21,Seattle Seahawks,17,0,0,0,0,1,0,4,38,2018-09-19T20:14:47.239Z,Facebook_10101964290128875,2
47,2018,3,New England Patriots,24,Detroit Lions,14,0,0,0,0,1,0,10,38,2018-09-19T20:15:00.840Z,Facebook_10101964290128875,2
48,2018,3,Pittsburgh Steelers,24,Tampa Bay Buccaneers,30,0,0,0,0,0,0,-6,54,2018-09-19T20:15:20.643Z,Facebook_10101964290128875,0
41,2018,3,Indianapolis Colts,21,Philadelphia Eagles,31,1,0,0,0,0,0,-10,52,2018-09-20T00:54:23.521Z,chrisl777,2
39,2018,3,San Francisco 49ers,17,Kansas City Chiefs,28,1,0,1,0,0,0,-11,45,2018-09-20T00:54:33.418Z,chrisl777,5
36,2018,3,Tennessee Titans,10,Jacksonville Jaguars,27,0,0,0,0,1,0,-17,37,2018-09-20T00:54:59.257Z,chrisl777,2
44,2018,3,Los Angeles Chargers,31,Los Angeles Rams,33,1,0,0,0,1,0,-2,64,2018-09-20T00:55:25.724Z,chrisl777,4
48,2018,3,Pittsburgh Steelers,27,Tampa Bay Buccaneers,31,0,0,0,0,1,0,-4,58,2018-09-20T01:02:13.720Z,chrisl777,2
33,2018,3,New York Jets,21,Cleveland Browns,27,1,0,1,0,0,0,-6,48,2018-09-20T14:43:49.778Z,Facebook_10205896813734452,4
33,2018,3,New York Jets,17,Cleveland Browns,24,1,0,1,0,0,0,-7,41,2018-09-20T18:34:15.536Z,eddiefeeley,5
40,2018,3,Green Bay Packers,28,Washington Redskins,24,0,0,0,0,1,0,4,52,2018-09-20T18:34:43.276Z,eddiefeeley,2
42,2018,3,Oakland Raiders,10,Miami Dolphins,24,1,0,1,0,0,0,-14,34,2018-09-20T18:35:06.376Z,eddiefeeley,4
33,2018,3,New York Jets,15,Cleveland Browns,17,1,0,0,0,1,0,-2,32,2018-09-18T20:36:08.015Z,cmaronchick,4
38,2018,3,New Orleans Saints,34,Atlanta Falcons,26,1,0,1,0,1,0,8,60,2018-09-20T18:35:21.336Z,eddiefeeley,6
37,2018,3,Denver Broncos,13,Baltimore Ravens,21,1,0,1,0,1,0,-8,34,2018-09-20T18:35:34.681Z,eddiefeeley,6
35,2018,3,New York Giants,13,Houston Texans,20,0,0,0,0,0,0,-7,33,2018-09-20T18:35:47.937Z,eddiefeeley,0
41,2018,3,Indianapolis Colts,21,Philadelphia Eagles,31,1,0,0,0,0,0,-10,52,2018-09-20T18:36:07.116Z,eddiefeeley,2
39,2018,3,San Francisco 49ers,28,Kansas City Chiefs,35,1,0,1,0,1,0,-7,63,2018-09-20T18:36:21.519Z,eddiefeeley,6
36,2018,3,Tennessee Titans,7,Jacksonville Jaguars,24,0,0,0,0,1,0,-17,31,2018-09-20T18:36:37.437Z,eddiefeeley,2
43,2018,3,Buffalo Bills,10,Minnesota Vikings,26,0,0,1,0,1,0,-16,36,2018-09-20T18:36:57.536Z,eddiefeeley,4
34,2018,3,Cincinnati Bengals,17,Carolina Panthers,21,1,0,1,0,0,0,-4,38,2018-09-20T18:37:14.818Z,eddiefeeley,4
44,2018,3,Los Angeles Chargers,24,Los Angeles Rams,21,0,0,0,0,0,0,3,45,2018-09-20T18:37:29.055Z,eddiefeeley,0
45,2018,3,Chicago Bears,27,Arizona Cardinals,10,1,0,0,0,1,0,17,37,2018-09-20T18:37:57.400Z,eddiefeeley,4
46,2018,3,Dallas Cowboys,17,Seattle Seahawks,20,1,0,1,0,1,0,-3,37,2018-09-20T18:38:06.760Z,eddiefeeley,7
47,2018,3,New England Patriots,31,Detroit Lions,24,0,0,0,0,0,0,7,55,2018-09-20T18:39:14.098Z,eddiefeeley,0
48,2018,3,Pittsburgh Steelers,31,Tampa Bay Buccaneers,28,1,0,1,0,1,0,3,59,2018-09-20T18:39:53.678Z,eddiefeeley,7
33,2018,3,New York Jets,24,Cleveland Browns,17,0,0,0,0,0,0,7,41,2018-09-20T18:49:37.697Z,Facebook_10210894378652618,0
40,2018,3,Green Bay Packers,21,Washington Redskins,24,1,0,1,0,0,0,-3,45,2018-09-20T18:49:52.536Z,Facebook_10210894378652618,4
42,2018,3,Oakland Raiders,17,Miami Dolphins,24,1,0,1,0,0,0,-7,41,2018-09-20T18:50:09.375Z,Facebook_10210894378652618,4
38,2018,3,New Orleans Saints,24,Atlanta Falcons,27,0,0,0,0,0,0,-3,51,2018-09-20T18:50:21.598Z,Facebook_10210894378652618,0
35,2018,3,New York Giants,10,Houston Texans,24,0,0,0,0,0,0,-14,34,2018-09-20T18:50:32.598Z,Facebook_10210894378652618,0
37,2018,3,Denver Broncos,21,Baltimore Ravens,28,1,0,1,0,0,0,-7,49,2018-09-20T18:50:45.817Z,Facebook_10210894378652618,4
39,2018,3,San Francisco 49ers,20,Kansas City Chiefs,24,1,0,0,0,0,0,-4,44,2018-09-20T18:51:04.217Z,Facebook_10210894378652618,2
41,2018,3,Indianapolis Colts,17,Philadelphia Eagles,24,1,0,0,0,1,0,-7,41,2018-09-20T18:51:40.439Z,Facebook_10210894378652618,4
36,2018,3,Tennessee Titans,20,Jacksonville Jaguars,27,0,0,1,0,0,0,-7,47,2018-09-20T18:52:32.476Z,Facebook_10210894378652618,2
43,2018,3,Buffalo Bills,10,Minnesota Vikings,21,0,0,1,0,1,0,-11,31,2018-09-20T18:52:45.917Z,Facebook_10210894378652618,4
34,2018,3,Cincinnati Bengals,21,Carolina Panthers,24,1,0,1,0,1,0,-3,45,2018-09-20T18:53:03.258Z,Facebook_10210894378652618,7
44,2018,3,Los Angeles Chargers,17,Los Angeles Rams,28,1,0,1,0,0,0,-11,45,2018-09-20T18:53:21.676Z,Facebook_10210894378652618,4
45,2018,3,Chicago Bears,17,Arizona Cardinals,21,0,0,1,0,1,0,-4,38,2018-09-20T18:53:38.477Z,Facebook_10210894378652618,4
46,2018,3,Dallas Cowboys,21,Seattle Seahawks,24,1,0,1,0,0,0,-3,45,2018-09-20T18:53:48.377Z,Facebook_10210894378652618,5
47,2018,3,New England Patriots,31,Detroit Lions,17,0,0,0,0,1,0,14,48,2018-09-20T18:54:44.177Z,Facebook_10210894378652618,2
48,2018,3,Pittsburgh Steelers,17,Tampa Bay Buccaneers,28,0,0,0,0,0,0,-11,45,2018-09-20T18:54:53.918Z,Facebook_10210894378652618,0
33,2018,3,New York Jets,24,Cleveland Browns,20,0,0,0,0,0,0,4,44,2018-09-20T22:16:52.056Z,Facebook_10154523075462819,0
33,2018,3,New York Jets,18,Cleveland Browns,21,1,0,0,0,1,0,-3,39,2018-09-19T03:49:01.786Z,psmeyerlaw,5
33,2018,3,New York Jets,14,Cleveland Browns,17,1,0,0,0,1,0,-3,31,2018-09-20T00:52:18.158Z,chrisl777,4
40,2018,3,Green Bay Packers,24,Washington Redskins,14,0,0,0,0,0,0,10,38,2018-09-21T03:45:59.653Z,Facebook_10154773754448953,0
42,2018,3,Oakland Raiders,20,Miami Dolphins,27,1,0,1,0,1,0,-7,47,2018-09-21T03:48:45.495Z,Facebook_10154773754448953,7
38,2018,3,New Orleans Saints,21,Atlanta Falcons,24,0,0,0,0,0,0,-3,45,2018-09-21T03:51:30.293Z,Facebook_10154773754448953,0
37,2018,3,Denver Broncos,17,Baltimore Ravens,24,1,0,1,0,1,0,-7,41,2018-09-21T03:52:09.175Z,Facebook_10154773754448953,7
35,2018,3,New York Giants,14,Houston Texans,21,0,0,0,0,0,0,-7,35,2018-09-21T03:52:53.371Z,Facebook_10154773754448953,0
41,2018,3,Indianapolis Colts,14,Philadelphia Eagles,28,1,0,0,0,1,0,-14,42,2018-09-21T03:53:14.712Z,Facebook_10154773754448953,4
39,2018,3,San Francisco 49ers,21,Kansas City Chiefs,24,1,0,0,0,0,0,-3,45,2018-09-21T03:53:24.354Z,Facebook_10154773754448953,2
36,2018,3,Tennessee Titans,17,Jacksonville Jaguars,21,0,0,1,0,1,0,-4,38,2018-09-21T03:54:14.131Z,Facebook_10154773754448953,4
43,2018,3,Buffalo Bills,10,Minnesota Vikings,28,0,0,0,0,1,0,-18,38,2018-09-21T03:55:19.470Z,Facebook_10154773754448953,2
34,2018,3,Cincinnati Bengals,24,Carolina Panthers,27,1,0,1,0,1,0,-3,51,2018-09-21T03:56:01.954Z,Facebook_10154773754448953,6
44,2018,3,Los Angeles Chargers,17,Los Angeles Rams,28,1,0,1,0,0,0,-11,45,2018-09-21T03:56:25.534Z,Facebook_10154773754448953,4
45,2018,3,Chicago Bears,21,Arizona Cardinals,13,1,0,0,0,1,0,8,34,2018-09-21T03:56:53.611Z,Facebook_10154773754448953,4
46,2018,3,Dallas Cowboys,17,Seattle Seahawks,20,1,0,1,0,1,0,-3,37,2018-09-21T03:57:03.072Z,Facebook_10154773754448953,7
47,2018,3,New England Patriots,24,Detroit Lions,17,0,0,0,0,1,0,7,41,2018-09-21T03:57:12.613Z,Facebook_10154773754448953,2
48,2018,3,Pittsburgh Steelers,21,Tampa Bay Buccaneers,20,1,0,1,0,0,0,1,41,2018-09-21T03:57:24.071Z,Facebook_10154773754448953,4
43,2018,3,Buffalo Bills,3,Minnesota Vikings,33,0,0,0,0,1,0,-30,36,2018-09-20T00:55:08.238Z,chrisl777,2
45,2018,3,Chicago Bears,27,Arizona Cardinals,7,1,0,0,0,1,0,20,34,2018-09-22T00:09:02.368Z,chrisl777,4
40,2018,3,Green Bay Packers,27,Washington Redskins,17,0,0,0,0,0,0,10,44,2018-09-23T03:31:23.311Z,Facebook_10154523075462819,0
42,2018,3,Oakland Raiders,21,Miami Dolphins,20,0,0,0,0,0,0,1,41,2018-09-23T03:31:58.630Z,Facebook_10154523075462819,0
38,2018,3,New Orleans Saints,21,Atlanta Falcons,24,0,0,0,0,0,0,-3,45,2018-09-23T03:32:51.309Z,Facebook_10154523075462819,0
38,2018,3,New Orleans Saints,28,Atlanta Falcons,31,0,0,0,0,1,0,-3,59,2018-09-23T03:32:52.808Z,cmaronchick,2
37,2018,3,Denver Broncos,17,Baltimore Ravens,20,1,0,0,0,1,0,-3,37,2018-09-23T03:33:09.274Z,cmaronchick,4
37,2018,3,Denver Broncos,21,Baltimore Ravens,23,1,0,0,0,1,0,-2,44,2018-09-23T03:33:20.232Z,Facebook_10154523075462819,4
35,2018,3,New York Giants,17,Houston Texans,24,0,0,0,0,0,0,-7,41,2018-09-23T03:35:57.509Z,Facebook_10154523075462819,0
41,2018,3,Indianapolis Colts,17,Philadelphia Eagles,27,1,0,0,0,1,0,-10,44,2018-09-23T03:36:13.308Z,Facebook_10154523075462819,4
39,2018,3,San Francisco 49ers,13,Kansas City Chiefs,24,1,0,1,0,0,0,-11,37,2018-09-23T03:36:38.868Z,Facebook_10154523075462819,5
36,2018,3,Tennessee Titans,13,Jacksonville Jaguars,24,0,0,0,0,1,0,-11,37,2018-09-23T03:36:53.188Z,Facebook_10154523075462819,2
43,2018,3,Buffalo Bills,10,Minnesota Vikings,24,0,0,1,0,1,0,-14,34,2018-09-23T03:37:33.789Z,Facebook_10154523075462819,4
34,2018,3,Cincinnati Bengals,13,Carolina Panthers,18,1,0,1,0,0,0,-5,31,2018-09-23T03:38:09.191Z,Facebook_10154523075462819,4
44,2018,3,Los Angeles Chargers,24,Los Angeles Rams,34,1,0,1,0,1,0,-10,58,2018-09-23T03:39:40.968Z,Facebook_10154523075462819,7
45,2018,3,Chicago Bears,24,Arizona Cardinals,13,1,0,0,0,1,0,11,37,2018-09-23T03:40:08.669Z,Facebook_10154523075462819,4
46,2018,3,Dallas Cowboys,24,Seattle Seahawks,31,1,0,1,0,0,0,-7,55,2018-09-23T03:40:51.108Z,Facebook_10154523075462819,4
47,2018,3,New England Patriots,24,Detroit Lions,17,0,0,0,0,1,0,7,41,2018-09-23T03:41:28.589Z,Facebook_10154523075462819,2
48,2018,3,Pittsburgh Steelers,24,Tampa Bay Buccaneers,20,1,0,1,0,0,0,4,44,2018-09-23T03:42:15.791Z,Facebook_10154523075462819,4
35,2018,3,New York Giants,13,Houston Texans,23,0,0,0,0,0,0,-10,36,2018-09-23T03:43:59.331Z,cmaronchick,0
42,2018,3,Oakland Raiders,10,Miami Dolphins,21,1,0,1,0,0,0,-11,31,2018-09-23T03:58:49.229Z,Facebook_10155179314751475,4
40,2018,3,Green Bay Packers,21,Washington Redskins,17,0,0,0,0,0,0,4,38,2018-09-23T03:58:46.248Z,Facebook_10155179314751475,0
38,2018,3,New Orleans Saints,28,Atlanta Falcons,25,1,0,1,0,0,0,3,53,2018-09-23T03:59:07.432Z,Facebook_10155179314751475,4
37,2018,3,Denver Broncos,17,Baltimore Ravens,10,0,0,0,0,1,0,7,27,2018-09-23T03:59:14.812Z,Facebook_10155179314751475,2
35,2018,3,New York Giants,7,Houston Texans,17,0,0,0,0,0,0,-10,24,2018-09-23T03:59:27.050Z,Facebook_10155179314751475,0
41,2018,3,Indianapolis Colts,20,Philadelphia Eagles,21,1,0,1,0,1,0,-1,41,2018-09-23T03:59:37.375Z,Facebook_10155179314751475,6
39,2018,3,San Francisco 49ers,21,Kansas City Chiefs,35,1,0,1,0,1,0,-14,56,2018-09-23T03:59:48.689Z,Facebook_10155179314751475,6
36,2018,3,Tennessee Titans,3,Jacksonville Jaguars,17,0,0,0,0,1,0,-14,20,2018-09-23T03:59:55.612Z,Facebook_10155179314751475,2
43,2018,3,Buffalo Bills,3,Minnesota Vikings,21,0,0,0,0,1,0,-18,24,2018-09-23T04:00:05.650Z,Facebook_10155179314751475,2
34,2018,3,Cincinnati Bengals,17,Carolina Panthers,14,0,0,0,0,0,0,3,31,2018-09-23T04:00:12.734Z,Facebook_10155179314751475,0
44,2018,3,Los Angeles Chargers,31,Los Angeles Rams,28,0,0,0,0,1,0,3,59,2018-09-23T04:00:24.771Z,Facebook_10155179314751475,2
45,2018,3,Chicago Bears,21,Arizona Cardinals,7,1,0,0,0,1,0,14,28,2018-09-23T04:00:35.889Z,Facebook_10155179314751475,4
46,2018,3,Dallas Cowboys,17,Seattle Seahawks,20,1,0,1,0,1,0,-3,37,2018-09-23T04:00:47.213Z,Facebook_10155179314751475,7
47,2018,3,New England Patriots,28,Detroit Lions,3,0,0,0,0,1,0,25,31,2018-09-23T04:00:56.729Z,Facebook_10155179314751475,2
48,2018,3,Pittsburgh Steelers,38,Tampa Bay Buccaneers,17,1,0,1,0,1,0,21,55,2018-09-23T04:01:27.509Z,Facebook_10155179314751475,6
40,2018,3,Green Bay Packers,31,Washington Redskins,24,0,0,0,0,1,0,7,55,2018-09-23T16:31:04.213Z,Facebook_10205896813734452,2
38,2018,3,New Orleans Saints,21,Atlanta Falcons,27,0,0,0,0,0,0,-6,48,2018-09-23T16:30:56.519Z,Facebook_10205896813734452,0
41,2018,3,Indianapolis Colts,17,Philadelphia Eagles,31,1,0,0,0,0,0,-14,48,2018-09-23T16:30:48.385Z,Facebook_10205896813734452,2
42,2018,3,Oakland Raiders,13,Miami Dolphins,24,1,0,1,0,0,0,-11,37,2018-09-23T16:28:54.979Z,Facebook_10205896813734452,4
37,2018,3,Denver Broncos,21,Baltimore Ravens,27,1,0,1,0,0,0,-6,48,2018-09-23T16:29:10.284Z,Facebook_10205896813734452,5
43,2018,3,Buffalo Bills,17,Minnesota Vikings,27,0,0,1,0,0,0,-10,44,2018-09-23T16:29:28.580Z,Facebook_10205896813734452,2
34,2018,3,Cincinnati Bengals,21,Carolina Panthers,27,1,0,1,0,1,0,-6,48,2018-09-23T16:30:19.542Z,Facebook_10205896813734452,7
36,2018,3,Tennessee Titans,21,Jacksonville Jaguars,27,0,0,1,0,0,0,-6,48,2018-09-23T16:30:38.481Z,Facebook_10205896813734452,2
35,2018,3,New York Giants,17,Houston Texans,21,0,0,1,0,0,0,-4,38,2018-09-23T16:31:17.177Z,Facebook_10205896813734452,2
39,2018,3,San Francisco 49ers,17,Kansas City Chiefs,24,1,0,1,0,0,0,-7,41,2018-09-23T16:31:45.721Z,Facebook_10205896813734452,4
44,2018,3,Los Angeles Chargers,17,Los Angeles Rams,31,1,0,1,0,0,0,-14,48,2018-09-23T16:32:00.953Z,Facebook_10205896813734452,4
46,2018,3,Dallas Cowboys,24,Seattle Seahawks,27,1,0,1,0,0,0,-3,51,2018-09-23T16:32:16.161Z,Facebook_10205896813734452,4
45,2018,3,Chicago Bears,24,Arizona Cardinals,21,1,0,1,0,0,0,3,45,2018-09-23T16:33:17.760Z,Facebook_10205896813734452,4
47,2018,3,New England Patriots,31,Detroit Lions,24,0,0,0,0,0,0,7,55,2018-09-23T16:33:30.900Z,Facebook_10205896813734452,0
48,2018,3,Pittsburgh Steelers,21,Tampa Bay Buccaneers,27,0,0,0,0,0,0,-6,48,2018-09-23T16:34:00.779Z,Facebook_10205896813734452,1
40,2018,3,Green Bay Packers,31,Washington Redskins,24,0,0,0,0,1,0,7,55,2018-09-23T16:48:21.661Z,Facebook_10213631282628797,2
42,2018,3,Oakland Raiders,24,Miami Dolphins,16,0,0,0,0,0,0,8,40,2018-09-23T16:48:48.182Z,Facebook_10213631282628797,0
37,2018,3,Denver Broncos,17,Baltimore Ravens,13,0,0,0,0,1,0,4,30,2018-09-23T16:50:23.341Z,Facebook_10213631282628797,2
35,2018,3,New York Giants,20,Houston Texans,24,0,0,1,0,0,0,-4,44,2018-09-23T16:50:51.342Z,Facebook_10213631282628797,2
41,2018,3,Indianapolis Colts,17,Philadelphia Eagles,20,1,0,1,0,1,0,-3,37,2018-09-23T16:51:34.079Z,Facebook_10213631282628797,7
39,2018,3,San Francisco 49ers,34,Kansas City Chiefs,41,1,0,1,0,1,0,-7,75,2018-09-23T16:52:45.722Z,Facebook_10213631282628797,6
36,2018,3,Tennessee Titans,10,Jacksonville Jaguars,31,0,0,0,0,0,0,-21,41,2018-09-23T16:53:12.419Z,Facebook_10213631282628797,0
34,2018,3,Cincinnati Bengals,21,Carolina Panthers,24,1,0,1,0,1,0,-3,45,2018-09-23T16:54:26.181Z,Facebook_10213631282628797,7
44,2018,3,Los Angeles Chargers,24,Los Angeles Rams,28,1,0,0,0,1,0,-4,52,2018-09-23T16:58:03.080Z,Facebook_10154993923975769,4
46,2018,3,Dallas Cowboys,28,Seattle Seahawks,35,1,0,1,0,0,0,-7,63,2018-09-23T16:58:14.824Z,Facebook_10154993923975769,4
47,2018,3,New England Patriots,31,Detroit Lions,14,0,0,0,0,1,0,17,45,2018-09-23T16:58:24.659Z,Facebook_10154993923975769,2
48,2018,3,Pittsburgh Steelers,35,Tampa Bay Buccaneers,21,1,0,1,0,1,0,14,56,2018-09-23T16:58:34.925Z,Facebook_10154993923975769,6
45,2018,3,Chicago Bears,35,Arizona Cardinals,21,1,0,0,0,0,0,14,56,2018-09-23T16:59:07.680Z,Facebook_10154993923975769,2
40,2018,3,Green Bay Packers,24,Washington Redskins,18,0,0,0,0,0,0,6,42,2018-09-23T16:58:14.824Z,Facebook_10154993923975769,0
42,2018,3,Oakland Raiders,14,Miami Dolphins,7,0,0,0,0,0,0,7,21,2018-09-23T16:58:14.824Z,Facebook_10154993923975769,0
38,2018,3,New Orleans Saints,35,Atlanta Falcons,21,1,0,1,0,1,0,14,56,2018-09-23T16:58:14.824Z,Facebook_10154993923975769,6
37,2018,3,Denver Broncos,28,Baltimore Ravens,14,0,0,0,0,1,0,14,42,2018-09-23T16:58:14.824Z,Facebook_10154993923975769,2
35,2018,3,New York Giants,24,Houston Texans,21,1,0,1,0,1,0,3,45,2018-09-23T16:58:14.824Z,Facebook_10154993923975769,6
41,2018,3,Indianapolis Colts,35,Philadelphia Eagles,21,0,0,1,0,0,0,14,55,2018-09-23T16:58:14.824Z,Facebook_10154993923975769,2
39,2018,3,San Francisco 49ers,14,Kansas City Chiefs,14,0,0,0,0,0,0,0,28,2018-09-23T16:58:14.824Z,Facebook_10154993923975769,0
36,2018,3,Tennessee Titans,18,Jacksonville Jaguars,14,1,0,1,0,1,0,4,32,2018-09-23T16:58:14.824Z,Facebook_10154993923975769,6
43,2018,3,Buffalo Bills,7,Minnesota Vikings,21,0,0,1,0,1,0,-14,28,2018-09-23T16:58:14.824Z,Facebook_10154993923975769,4
34,2018,3,Cincinnati Bengals,21,Carolina Panthers,24,1,0,1,0,1,0,-3,45,2018-09-23T16:58:14.824Z,Facebook_10154993923975769,7
45,2018,3,Chicago Bears,21,Arizona Cardinals,13,1,0,0,0,1,0,8,34,2018-09-23T20:00:49.280Z,Facebook_10213631282628797,4
46,2018,3,Dallas Cowboys,28,Seattle Seahawks,20,0,0,0,0,0,0,8,48,2018-09-23T20:01:36.219Z,Facebook_10213631282628797,0
47,2018,3,New England Patriots,38,Detroit Lions,20,0,0,0,0,0,0,18,58,2018-09-23T20:02:03.180Z,Facebook_10213631282628797,0
48,2018,3,Pittsburgh Steelers,38,Tampa Bay Buccaneers,41,0,0,0,0,1,0,-3,79,2018-09-23T20:02:45.420Z,Facebook_10213631282628797,2
47,2018,3,New England Patriots,38,Detroit Lions,14,0,0,0,0,1,0,24,52,2018-09-23T20:05:53.093Z,Facebook_10214777580983458,2
46,2018,3,Dallas Cowboys,12,Seattle Seahawks,13,1,0,0,0,1,0,-1,25,2018-09-23T20:05:52.182Z,Facebook_10214777580983458,4
48,2018,3,Pittsburgh Steelers,32,Tampa Bay Buccaneers,28,1,0,1,0,1,0,4,60,2018-09-23T20:05:56.560Z,Facebook_10214777580983458,6
45,2018,3,Chicago Bears,21,Arizona Cardinals,12,1,0,0,0,1,0,9,33,2018-09-23T20:05:49.422Z,Facebook_10214777580983458,4
42,2018,3,Oakland Raiders,19,Miami Dolphins,23,1,0,1,0,0,0,-4,42,2018-09-20T06:10:07.773Z,cmaronchick,4
42,2018,3,Oakland Raiders,20,Miami Dolphins,23,1,0,0,0,0,0,-3,43,2018-09-19T03:49:36.025Z,psmeyerlaw,3
42,2018,3,Oakland Raiders,21,Miami Dolphins,17,0,0,0,0,0,0,4,38,2018-09-20T00:53:08.056Z,chrisl777,0
37,2018,3,Denver Broncos,19,Baltimore Ravens,24,1,0,0,0,1,0,-5,43,2018-09-19T03:50:17.168Z,psmeyerlaw,4
37,2018,3,Denver Broncos,21,Baltimore Ravens,17,0,0,0,0,1,0,4,38,2018-09-20T00:53:44.218Z,chrisl777,2
35,2018,3,New York Giants,17,Houston Texans,23,0,0,0,0,0,0,-6,40,2018-09-19T03:50:41.959Z,psmeyerlaw,0
35,2018,3,New York Giants,10,Houston Texans,7,1,0,1,0,0,0,3,17,2018-09-20T00:54:14.696Z,chrisl777,4
34,2018,3,Cincinnati Bengals,24,Carolina Panthers,20,0,0,0,0,0,0,4,44,2018-09-18T20:38:50.075Z,cmaronchick,0
34,2018,3,Cincinnati Bengals,21,Carolina Panthers,27,1,0,1,0,1,0,-6,48,2018-09-20T00:55:19.058Z,chrisl777,7
41,2018,3,Indianapolis Colts,24,Philadelphia Eagles,34,1,0,0,0,0,0,-10,58,2018-09-18T20:40:12.398Z,cmaronchick,2
43,2018,3,Buffalo Bills,7,Minnesota Vikings,35,0,0,0,0,0,0,-28,42,2018-09-18T20:41:52.362Z,cmaronchick,0
43,2018,3,Buffalo Bills,12,Minnesota Vikings,29,0,0,0,0,0,0,-17,41,2018-09-19T03:55:42.128Z,psmeyerlaw,0
36,2018,3,Tennessee Titans,10,Jacksonville Jaguars,27,0,0,0,0,1,0,-17,37,2018-09-18T20:41:32.256Z,cmaronchick,2
40,2018,3,Green Bay Packers,28,Washington Redskins,24,0,0,0,0,1,0,4,52,2018-09-18T20:36:35.019Z,cmaronchick,2
40,2018,3,Green Bay Packers,31,Washington Redskins,7,0,0,0,0,0,0,24,38,2018-09-20T00:52:59.619Z,chrisl777,0
38,2018,3,New Orleans Saints,25,Atlanta Falcons,28,0,0,0,0,0,0,-3,53,2018-09-19T03:49:52.890Z,psmeyerlaw,0
38,2018,3,New Orleans Saints,28,Atlanta Falcons,27,1,0,1,0,1,0,1,55,2018-09-20T00:53:15.737Z,chrisl777,6
39,2018,3,San Francisco 49ers,28,Kansas City Chiefs,34,1,0,1,0,1,0,-6,62,2018-09-18T20:40:38.995Z,cmaronchick,6
44,2018,3,Los Angeles Chargers,31,Los Angeles Rams,35,1,0,0,0,1,0,-4,66,2018-09-18T20:42:11.695Z,cmaronchick,5
46,2018,3,Dallas Cowboys,17,Seattle Seahawks,23,1,0,1,0,0,0,-6,40,2018-09-18T20:42:40.517Z,cmaronchick,4
46,2018,3,Dallas Cowboys,20,Seattle Seahawks,21,1,0,0,0,0,0,-1,41,2018-09-19T03:56:50.488Z,psmeyerlaw,2
46,2018,3,Dallas Cowboys,27,Seattle Seahawks,20,0,0,0,0,0,0,7,47,2018-09-20T01:01:54.296Z,chrisl777,0
45,2018,3,Chicago Bears,17,Arizona Cardinals,10,1,0,0,0,1,0,7,27,2018-09-18T20:42:27.737Z,cmaronchick,4
45,2018,3,Chicago Bears,22,Arizona Cardinals,16,1,0,0,0,1,0,6,38,2018-09-19T03:56:33.667Z,psmeyerlaw,4
47,2018,3,New England Patriots,34,Detroit Lions,10,0,0,0,0,1,0,24,44,2018-09-18T20:42:50.622Z,cmaronchick,2
47,2018,3,New England Patriots,28,Detroit Lions,22,0,0,1,0,1,0,6,50,2018-09-19T03:57:05.539Z,psmeyerlaw,4
47,2018,3,New England Patriots,31,Detroit Lions,10,0,0,0,0,1,0,21,41,2018-09-20T01:02:09.462Z,chrisl777,2
48,2018,3,Pittsburgh Steelers,27,Tampa Bay Buccaneers,24,1,0,1,0,0,0,3,51,2018-09-18T20:43:05.976Z,cmaronchick,5
49,2018,4,Minnesota Vikings,24,Los Angeles Rams,28,1,0,0,1,1,0,-4,52,2018-09-27T21:45:27.135Z,cmaronchick,4
57,2018,4,Miami Dolphins,13,New England Patriots,34,1,0,1,0,1,0,-21,47,2018-09-28T20:42:45.264Z,cmaronchick,6
56,2018,4,Philadelphia Eagles,27,Tennessee Titans,14,0,0,0,0,0,0,13,41,2018-09-28T18:54:03.703Z,cmaronchick,0
55,2018,4,New York Jets,10,Jacksonville Jaguars,21,1,0,1,0,0,0,-11,31,2018-09-28T19:43:21.005Z,cmaronchick,4
54,2018,4,Cincinnati Bengals,24,Atlanta Falcons,27,0,0,1,0,0,0,-3,51,2018-09-28T19:49:01.682Z,cmaronchick,2
53,2018,4,Tampa Bay Buccaneers,20,Chicago Bears,13,0,0,0,0,0,0,7,33,2018-09-28T20:45:30.944Z,cmaronchick,0
52,2018,4,Houston Texans,13,Indianapolis Colts,19,0,0,0,0,0,0,-6,32,2018-09-28T22:38:30.942Z,cmaronchick,0
51,2018,4,Buffalo Bills,17,Green Bay Packers,24,1,0,0,0,1,0,-7,41,2018-09-28T22:13:06.923Z,cmaronchick,4
50,2018,4,Detroit Lions,24,Dallas Cowboys,16,0,0,1,0,0,0,8,40,2018-09-26T01:54:45.634Z,cmaronchick,3
59,2018,4,Cleveland Browns,20,Oakland Raiders,19,0,0,0,0,0,0,1,39,2018-09-26T01:54:58.452Z,cmaronchick,0
58,2018,4,Seattle Seahawks,30,Arizona Cardinals,13,1,0,0,0,0,0,17,43,2018-09-26T01:55:20.274Z,cmaronchick,2
61,2018,4,San Francisco 49ers,10,Los Angeles Chargers,34,1,0,0,0,0,0,-24,44,2018-09-26T01:55:31.813Z,cmaronchick,2
60,2018,4,New Orleans Saints,34,New York Giants,19,1,0,1,0,0,0,15,53,2018-09-26T01:55:58.660Z,cmaronchick,5
62,2018,4,Baltimore Ravens,24,Pittsburgh Steelers,23,1,0,1,0,1,0,1,47,2018-09-26T01:56:12.673Z,cmaronchick,6
63,2018,4,Kansas City Chiefs,34,Denver Broncos,20,1,0,1,0,0,0,14,54,2018-09-26T01:56:25.853Z,cmaronchick,4
56,2018,4,Philadelphia Eagles,22,Tennessee Titans,18,0,0,0,0,0,0,4,40,2018-09-26T03:46:46.814Z,psmeyerlaw,0
55,2018,4,New York Jets,15,Jacksonville Jaguars,23,1,0,1,0,0,0,-8,38,2018-09-26T03:47:02.914Z,psmeyerlaw,4
61,2018,4,San Francisco 49ers,18,Los Angeles Chargers,29,1,0,0,0,1,0,-11,47,2018-09-26T03:50:06.995Z,psmeyerlaw,5
60,2018,4,New Orleans Saints,26,New York Giants,23,1,0,0,0,1,0,3,49,2018-09-26T03:50:25.356Z,psmeyerlaw,4
62,2018,4,Baltimore Ravens,23,Pittsburgh Steelers,27,0,0,0,0,1,0,-4,50,2018-09-26T03:50:46.157Z,psmeyerlaw,2
49,2018,4,Minnesota Vikings,21,Los Angeles Rams,35,1,0,0,1,1,0,-14,56,2018-09-26T20:12:37.189Z,eddiefeeley,4
57,2018,4,Miami Dolphins,28,New England Patriots,31,1,0,0,0,0,0,-3,59,2018-09-26T20:15:12.030Z,eddiefeeley,2
56,2018,4,Philadelphia Eagles,24,Tennessee Titans,9,0,0,0,0,0,0,15,33,2018-09-26T20:15:43.887Z,eddiefeeley,0
55,2018,4,New York Jets,7,Jacksonville Jaguars,24,1,0,1,0,0,0,-17,31,2018-09-26T20:15:56.948Z,eddiefeeley,4
54,2018,4,Cincinnati Bengals,35,Atlanta Falcons,31,1,0,1,0,1,0,4,66,2018-09-26T20:16:15.209Z,eddiefeeley,6
53,2018,4,Tampa Bay Buccaneers,17,Chicago Bears,20,1,0,0,0,0,0,-3,37,2018-09-26T20:16:30.949Z,eddiefeeley,2
52,2018,4,Houston Texans,16,Indianapolis Colts,20,0,0,0,0,0,0,-4,36,2018-09-26T20:17:15.768Z,eddiefeeley,0
51,2018,4,Buffalo Bills,14,Green Bay Packers,28,1,0,1,0,1,0,-14,42,2018-09-26T20:17:25.388Z,eddiefeeley,6
50,2018,4,Detroit Lions,31,Dallas Cowboys,17,0,0,1,0,1,0,14,48,2018-09-26T20:17:54.490Z,eddiefeeley,4
59,2018,4,Cleveland Browns,24,Oakland Raiders,17,0,0,0,0,0,0,7,41,2018-09-26T20:19:34.530Z,eddiefeeley,0
58,2018,4,Seattle Seahawks,27,Arizona Cardinals,10,1,0,0,0,1,0,17,37,2018-09-26T20:19:45.929Z,eddiefeeley,5
61,2018,4,San Francisco 49ers,10,Los Angeles Chargers,31,1,0,0,0,0,0,-21,41,2018-09-26T20:20:58.807Z,eddiefeeley,2
60,2018,4,New Orleans Saints,31,New York Giants,24,1,0,1,0,0,0,7,55,2018-09-26T20:21:46.209Z,eddiefeeley,4
62,2018,4,Baltimore Ravens,14,Pittsburgh Steelers,17,0,0,0,0,1,0,-3,31,2018-09-26T20:22:16.308Z,eddiefeeley,2
63,2018,4,Kansas City Chiefs,38,Denver Broncos,24,1,0,1,0,0,0,14,62,2018-09-26T20:22:27.987Z,eddiefeeley,4
49,2018,4,Minnesota Vikings,13,Los Angeles Rams,28,1,0,0,1,0,0,-15,41,2018-09-26T22:53:42.890Z,Facebook_10101964290128875,2
57,2018,4,Miami Dolphins,17,New England Patriots,20,1,0,0,0,1,0,-3,37,2018-09-26T22:53:55.077Z,Facebook_10101964290128875,4
56,2018,4,Philadelphia Eagles,24,Tennessee Titans,13,0,0,0,0,0,0,11,37,2018-09-26T22:54:26.208Z,Facebook_10101964290128875,0
55,2018,4,New York Jets,13,Jacksonville Jaguars,28,1,0,1,0,1,0,-15,41,2018-09-26T22:54:55.789Z,Facebook_10101964290128875,6
54,2018,4,Cincinnati Bengals,24,Atlanta Falcons,30,0,0,0,0,1,0,-6,54,2018-09-26T22:55:08.182Z,Facebook_10101964290128875,2
53,2018,4,Tampa Bay Buccaneers,31,Chicago Bears,20,0,0,0,0,1,0,11,51,2018-09-26T22:55:18.269Z,Facebook_10101964290128875,2
52,2018,4,Houston Texans,17,Indianapolis Colts,14,1,0,1,0,0,0,3,31,2018-09-26T22:55:33.007Z,Facebook_10101964290128875,5
51,2018,4,Buffalo Bills,13,Green Bay Packers,35,1,0,1,0,0,0,-22,48,2018-09-26T22:55:55.168Z,Facebook_10101964290128875,5
50,2018,4,Detroit Lions,21,Dallas Cowboys,17,0,0,1,0,0,0,4,38,2018-09-26T22:56:12.868Z,Facebook_10101964290128875,2
59,2018,4,Cleveland Browns,24,Oakland Raiders,20,0,0,0,0,0,0,4,44,2018-09-26T22:56:26.129Z,Facebook_10101964290128875,0
58,2018,4,Seattle Seahawks,21,Arizona Cardinals,17,1,0,0,0,1,0,4,38,2018-09-26T22:56:39.808Z,Facebook_10101964290128875,5
61,2018,4,San Francisco 49ers,13,Los Angeles Chargers,21,1,0,1,0,0,0,-8,34,2018-09-26T22:56:51.669Z,Facebook_10101964290128875,4
60,2018,4,New Orleans Saints,30,New York Giants,17,1,0,1,0,1,0,13,47,2018-09-26T22:57:04.288Z,Facebook_10101964290128875,6
62,2018,4,Baltimore Ravens,27,Pittsburgh Steelers,34,0,0,0,0,0,0,-7,61,2018-09-26T22:57:18.221Z,Facebook_10101964290128875,0
63,2018,4,Kansas City Chiefs,35,Denver Broncos,24,1,0,1,0,0,0,11,59,2018-09-26T22:57:31.511Z,Facebook_10101964290128875,4
49,2018,4,Minnesota Vikings,14,Los Angeles Rams,18,1,0,0,1,0,0,-4,32,2018-09-27T00:47:20.315Z,Facebook_10154993923975769,2
57,2018,4,Miami Dolphins,18,New England Patriots,28,1,0,1,0,1,0,-10,46,2018-09-27T00:47:33.076Z,Facebook_10154993923975769,6
56,2018,4,Philadelphia Eagles,24,Tennessee Titans,28,1,0,1,0,1,0,-4,52,2018-09-27T00:47:42.316Z,Facebook_10154993923975769,6
55,2018,4,New York Jets,14,Jacksonville Jaguars,7,0,0,0,0,0,0,7,21,2018-09-27T00:47:52.417Z,Facebook_10154993923975769,0
54,2018,4,Cincinnati Bengals,18,Atlanta Falcons,27,0,0,0,0,0,0,-9,45,2018-09-27T00:48:06.836Z,Facebook_10154993923975769,0
53,2018,4,Tampa Bay Buccaneers,21,Chicago Bears,14,0,0,0,0,0,0,7,35,2018-09-27T00:48:15.297Z,Facebook_10154993923975769,0
52,2018,4,Houston Texans,24,Indianapolis Colts,35,0,0,0,0,1,0,-11,59,2018-09-27T00:48:23.466Z,Facebook_10154993923975769,2
51,2018,4,Buffalo Bills,14,Green Bay Packers,35,1,0,1,0,0,0,-21,49,2018-09-27T00:48:38.176Z,Facebook_10154993923975769,4
50,2018,4,Detroit Lions,21,Dallas Cowboys,24,1,0,0,0,1,0,-3,45,2018-09-27T00:48:50.195Z,Facebook_10154993923975769,4
59,2018,4,Cleveland Browns,18,Oakland Raiders,14,0,0,0,0,0,0,4,32,2018-09-27T00:49:01.498Z,Facebook_10154993923975769,0
58,2018,4,Seattle Seahawks,21,Arizona Cardinals,14,1,0,0,0,1,0,7,35,2018-09-27T00:49:10.159Z,Facebook_10154993923975769,4
61,2018,4,San Francisco 49ers,21,Los Angeles Chargers,24,1,0,1,0,0,0,-3,45,2018-09-27T00:49:19.001Z,Facebook_10154993923975769,4
60,2018,4,New Orleans Saints,21,New York Giants,24,0,0,0,0,1,0,-3,45,2018-09-27T00:49:27.801Z,Facebook_10154993923975769,2
62,2018,4,Baltimore Ravens,15,Pittsburgh Steelers,18,0,0,0,0,1,0,-3,33,2018-09-27T00:49:46.755Z,Facebook_10154993923975769,2
63,2018,4,Kansas City Chiefs,14,Denver Broncos,18,0,0,0,0,1,0,-4,32,2018-09-27T00:49:58.374Z,Facebook_10154993923975769,2
49,2018,4,Minnesota Vikings,17,Los Angeles Rams,28,1,0,0,1,0,0,-11,45,2018-09-27T01:56:27.077Z,Facebook_10154773754448953,2
49,2018,4,Minnesota Vikings,24,Los Angeles Rams,31,1,0,0,1,1,0,-7,55,2018-09-27T14:35:33.206Z,Facebook_10205896813734452,5
49,2018,4,Minnesota Vikings,24,Los Angeles Rams,34,1,0,0,1,1,0,-10,58,2018-09-27T16:26:36.515Z,Facebook_10154523075462819,4
49,2018,4,Minnesota Vikings,17,Los Angeles Rams,31,1,0,0,1,0,0,-14,48,2018-09-27T20:13:38.854Z,Facebook_10210894378652618,2
57,2018,4,Miami Dolphins,18,New England Patriots,28,1,0,1,0,1,0,-10,46,2018-09-27T20:13:52.253Z,Facebook_10210894378652618,6
56,2018,4,Philadelphia Eagles,21,Tennessee Titans,24,1,0,1,0,1,0,-3,45,2018-09-27T20:14:00.133Z,Facebook_10210894378652618,7
55,2018,4,New York Jets,18,Jacksonville Jaguars,28,1,0,1,0,1,0,-10,46,2018-09-27T20:15:23.152Z,Facebook_10210894378652618,6
54,2018,4,Cincinnati Bengals,21,Atlanta Falcons,24,0,0,1,0,0,0,-3,45,2018-09-27T20:15:57.933Z,Facebook_10210894378652618,2
53,2018,4,Tampa Bay Buccaneers,24,Chicago Bears,28,1,0,1,0,1,0,-4,52,2018-09-27T20:16:09.513Z,Facebook_10210894378652618,6
51,2018,4,Buffalo Bills,14,Green Bay Packers,28,1,0,1,0,1,0,-14,42,2018-09-27T20:17:50.113Z,Facebook_10210894378652618,6
52,2018,4,Houston Texans,17,Indianapolis Colts,24,0,0,0,0,0,0,-7,41,2018-09-27T20:17:58.912Z,Facebook_10210894378652618,0
63,2018,4,Kansas City Chiefs,24,Denver Broncos,28,0,0,0,0,1,0,-4,52,2018-09-27T20:18:11.995Z,Facebook_10210894378652618,2
60,2018,4,New Orleans Saints,14,New York Giants,21,0,0,0,0,1,0,-7,35,2018-09-27T20:18:20.893Z,Facebook_10210894378652618,2
62,2018,4,Baltimore Ravens,21,Pittsburgh Steelers,24,0,0,0,0,1,0,-3,45,2018-09-27T20:18:29.615Z,Facebook_10210894378652618,2
58,2018,4,Seattle Seahawks,24,Arizona Cardinals,21,1,0,1,0,0,0,3,45,2018-09-27T20:18:48.132Z,Facebook_10210894378652618,5
61,2018,4,San Francisco 49ers,14,Los Angeles Chargers,28,1,0,0,0,0,0,-14,42,2018-09-27T20:18:56.067Z,Facebook_10210894378652618,2
59,2018,4,Cleveland Browns,24,Oakland Raiders,21,0,0,0,0,1,0,3,45,2018-09-27T20:19:07.053Z,Facebook_10210894378652618,2
50,2018,4,Detroit Lions,14,Dallas Cowboys,24,1,0,0,0,0,0,-10,38,2018-09-27T20:19:16.212Z,Facebook_10210894378652618,2
56,2018,4,Philadelphia Eagles,28,Tennessee Titans,7,0,0,0,0,0,0,21,35,2018-09-27T21:46:57.033Z,ineverwin,0
55,2018,4,New York Jets,7,Jacksonville Jaguars,20,1,0,1,0,0,0,-13,27,2018-09-27T21:46:57.992Z,ineverwin,4
61,2018,4,San Francisco 49ers,6,Los Angeles Chargers,34,1,0,0,0,0,0,-28,40,2018-09-27T21:49:03.319Z,ineverwin,2
60,2018,4,New Orleans Saints,42,New York Giants,35,1,0,1,0,0,0,7,77,2018-09-27T21:51:44.053Z,ineverwin,4
62,2018,4,Baltimore Ravens,13,Pittsburgh Steelers,14,0,0,1,0,1,0,-1,27,2018-09-27T21:51:51.833Z,ineverwin,5
49,2018,4,Minnesota Vikings,20,Los Angeles Rams,30,1,0,0,1,1,0,-10,50,2018-09-27T22:51:13.113Z,Facebook_10208710241577136,4
49,2018,4,Minnesota Vikings,24,Los Angeles Rams,28,1,0,0,1,1,0,-4,52,2018-09-27T22:49:25.772Z,Facebook_10213631282628797,4
61,2018,4,San Francisco 49ers,17,Los Angeles Chargers,27,1,0,0,0,0,0,-10,44,2018-09-27T22:59:14.413Z,murreya,2
50,2018,4,Detroit Lions,11,Dallas Cowboys,19,1,0,0,0,0,0,-8,30,2018-09-27T22:58:02.772Z,murreya,2
49,2018,4,Minnesota Vikings,27,Los Angeles Rams,31,1,0,0,1,1,0,-4,58,2018-09-27T23:05:52.254Z,chrisl777,4
57,2018,4,Miami Dolphins,7,New England Patriots,31,1,0,1,0,1,0,-24,38,2018-09-27T23:06:37.215Z,chrisl777,7
56,2018,4,Philadelphia Eagles,14,Tennessee Titans,10,0,0,0,0,0,0,4,24,2018-09-27T23:06:48.238Z,chrisl777,0
55,2018,4,New York Jets,24,Jacksonville Jaguars,21,0,0,0,0,1,0,3,45,2018-09-27T23:06:58.075Z,chrisl777,2
54,2018,4,Cincinnati Bengals,24,Atlanta Falcons,27,0,0,1,0,0,0,-3,51,2018-09-27T23:07:12.253Z,chrisl777,2
53,2018,4,Tampa Bay Buccaneers,14,Chicago Bears,10,0,0,0,0,0,0,4,24,2018-09-27T23:07:27.492Z,chrisl777,0
52,2018,4,Houston Texans,21,Indianapolis Colts,17,1,0,1,0,0,0,4,38,2018-09-27T23:07:36.653Z,chrisl777,4
51,2018,4,Buffalo Bills,13,Green Bay Packers,21,1,0,0,0,1,0,-8,34,2018-09-27T23:07:55.432Z,chrisl777,4
50,2018,4,Detroit Lions,14,Dallas Cowboys,17,1,0,0,0,0,0,-3,31,2018-09-27T23:08:07.476Z,chrisl777,2
59,2018,4,Cleveland Browns,17,Oakland Raiders,10,0,0,0,0,0,0,7,27,2018-09-27T23:08:17.217Z,chrisl777,0
58,2018,4,Seattle Seahawks,21,Arizona Cardinals,10,1,0,0,0,1,0,11,31,2018-09-27T23:08:33.455Z,chrisl777,4
61,2018,4,San Francisco 49ers,10,Los Angeles Chargers,31,1,0,0,0,0,0,-21,41,2018-09-27T23:08:46.373Z,chrisl777,2
60,2018,4,New Orleans Saints,21,New York Giants,17,1,0,1,0,1,0,4,38,2018-09-27T23:09:10.752Z,chrisl777,6
62,2018,4,Baltimore Ravens,21,Pittsburgh Steelers,31,0,0,0,0,0,0,-10,52,2018-09-27T23:09:26.573Z,chrisl777,0
63,2018,4,Kansas City Chiefs,27,Denver Broncos,17,1,0,1,0,1,0,10,44,2018-09-27T23:09:36.473Z,chrisl777,7
49,2018,4,Minnesota Vikings,25,Los Angeles Rams,32,1,0,0,1,1,0,-7,57,2018-09-27T23:35:56.591Z,idowhatican,5
57,2018,4,Miami Dolphins,14,New England Patriots,3,0,0,0,0,1,0,11,17,2018-09-27T23:36:24.690Z,idowhatican,2
56,2018,4,Philadelphia Eagles,20,Tennessee Titans,10,0,0,0,0,0,0,10,30,2018-09-27T23:36:46.131Z,idowhatican,0
57,2018,4,Miami Dolphins,24,New England Patriots,13,0,0,0,0,1,0,11,37,2018-09-28T00:21:51.869Z,Facebook_2410067802353317,2
56,2018,4,Philadelphia Eagles,21,Tennessee Titans,24,1,0,1,0,1,0,-3,45,2018-09-28T00:22:05.109Z,Facebook_2410067802353317,7
55,2018,4,New York Jets,12,Jacksonville Jaguars,30,1,0,1,0,1,0,-18,42,2018-09-28T00:22:19.193Z,Facebook_2410067802353317,7
54,2018,4,Cincinnati Bengals,21,Atlanta Falcons,24,0,0,1,0,0,0,-3,45,2018-09-28T00:22:29.609Z,Facebook_2410067802353317,2
53,2018,4,Tampa Bay Buccaneers,31,Chicago Bears,14,0,0,0,0,0,0,17,45,2018-09-28T00:22:36.771Z,Facebook_2410067802353317,0
58,2018,4,Seattle Seahawks,31,Arizona Cardinals,10,1,0,0,0,0,0,21,41,2018-09-28T00:23:00.629Z,Facebook_2410067802353317,2
61,2018,4,San Francisco 49ers,17,Los Angeles Chargers,38,1,0,0,0,1,0,-21,55,2018-09-28T00:23:17.789Z,Facebook_2410067802353317,4
52,2018,4,Houston Texans,17,Indianapolis Colts,20,0,0,0,0,0,0,-3,37,2018-09-28T00:23:44.190Z,Facebook_2410067802353317,0
51,2018,4,Buffalo Bills,10,Green Bay Packers,21,1,0,1,0,1,0,-11,31,2018-09-28T00:23:53.948Z,Facebook_2410067802353317,6
59,2018,4,Cleveland Browns,21,Oakland Raiders,17,0,0,0,0,0,0,4,38,2018-09-28T00:24:06.111Z,Facebook_2410067802353317,0
50,2018,4,Detroit Lions,24,Dallas Cowboys,14,0,0,1,0,0,0,10,38,2018-09-28T00:24:11.805Z,Facebook_2410067802353317,3
62,2018,4,Baltimore Ravens,28,Pittsburgh Steelers,28,0,0,1,0,0,0,0,56,2018-09-28T00:24:26.010Z,Facebook_2410067802353317,2
60,2018,4,New Orleans Saints,31,New York Giants,17,1,0,1,0,1,0,14,48,2018-09-28T00:24:38.532Z,Facebook_2410067802353317,6
63,2018,4,Kansas City Chiefs,30,Denver Broncos,28,1,0,0,0,0,0,2,58,2018-09-28T00:24:52.875Z,Facebook_2410067802353317,2
49,2018,4,Minnesota Vikings,21,Los Angeles Rams,28,1,0,0,1,1,0,-7,49,2018-09-26T03:46:02.756Z,psmeyerlaw,5
49,2018,4,Minnesota Vikings,14,Los Angeles Rams,35,1,0,0,1,1,0,-21,49,2018-09-27T21:46:31.191Z,ineverwin,4
49,2018,4,Minnesota Vikings,31,Los Angeles Rams,24,0,0,0,1,1,0,7,55,2018-09-27T22:55:10.892Z,murreya,3
56,2018,4,Philadelphia Eagles,24,Tennessee Titans,21,0,0,0,0,1,0,3,45,2018-09-29T01:54:47.946Z,Facebook_10154773754448953,2
55,2018,4,New York Jets,17,Jacksonville Jaguars,23,1,0,0,0,0,0,-6,40,2018-09-29T01:55:05.403Z,Facebook_10154773754448953,2
54,2018,4,Cincinnati Bengals,21,Atlanta Falcons,28,0,0,0,0,0,0,-7,49,2018-09-29T01:55:25.963Z,Facebook_10154773754448953,0
53,2018,4,Tampa Bay Buccaneers,17,Chicago Bears,21,1,0,1,0,0,0,-4,38,2018-09-29T01:55:47.883Z,Facebook_10154773754448953,4
52,2018,4,Houston Texans,20,Indianapolis Colts,21,0,0,0,0,0,0,-1,41,2018-09-29T01:56:06.086Z,Facebook_10154773754448953,0
51,2018,4,Buffalo Bills,17,Green Bay Packers,35,1,0,1,0,0,0,-18,52,2018-09-29T01:56:27.144Z,Facebook_10154773754448953,4
50,2018,4,Detroit Lions,13,Dallas Cowboys,17,1,0,0,0,0,0,-4,30,2018-09-29T01:56:44.184Z,Facebook_10154773754448953,2
57,2018,4,Miami Dolphins,17,New England Patriots,21,1,0,0,0,1,0,-4,38,2018-09-29T01:56:58.364Z,Facebook_10154773754448953,4
59,2018,4,Cleveland Browns,24,Oakland Raiders,21,0,0,0,0,1,0,3,45,2018-09-29T01:57:08.384Z,Facebook_10154773754448953,2
58,2018,4,Seattle Seahawks,27,Arizona Cardinals,13,1,0,0,0,0,0,14,40,2018-09-29T01:57:22.646Z,Facebook_10154773754448953,2
61,2018,4,San Francisco 49ers,13,Los Angeles Chargers,28,1,0,0,0,0,0,-15,41,2018-09-29T01:57:35.486Z,Facebook_10154773754448953,2
60,2018,4,New Orleans Saints,28,New York Giants,17,1,0,1,0,1,0,11,45,2018-09-29T01:57:50.704Z,Facebook_10154773754448953,6
63,2018,4,Kansas City Chiefs,28,Denver Broncos,24,1,0,1,0,1,0,4,52,2018-09-29T01:58:53.446Z,Facebook_10154773754448953,7
62,2018,4,Baltimore Ravens,21,Pittsburgh Steelers,27,0,0,0,0,1,0,-6,48,2018-09-29T02:00:29.324Z,Facebook_10154773754448953,2
56,2018,4,Philadelphia Eagles,24,Tennessee Titans,20,0,0,0,0,1,0,4,44,2018-09-29T17:46:45.211Z,Facebook_10208710241577136,2
55,2018,4,New York Jets,17,Jacksonville Jaguars,23,1,0,0,0,0,0,-6,40,2018-09-29T17:47:05.868Z,Facebook_10208710241577136,2
54,2018,4,Cincinnati Bengals,30,Atlanta Falcons,34,0,0,0,0,1,0,-4,64,2018-09-29T17:47:34.989Z,Facebook_10208710241577136,2
53,2018,4,Tampa Bay Buccaneers,24,Chicago Bears,27,1,0,0,0,1,0,-3,51,2018-09-29T17:48:26.651Z,Facebook_10208710241577136,4
52,2018,4,Houston Texans,20,Indianapolis Colts,24,0,0,0,0,0,0,-4,44,2018-09-29T18:09:09.891Z,Facebook_10208710241577136,0
51,2018,4,Buffalo Bills,20,Green Bay Packers,27,1,0,0,0,0,0,-7,47,2018-09-29T18:09:41.571Z,Facebook_10208710241577136,2
50,2018,4,Detroit Lions,24,Dallas Cowboys,20,0,0,1,0,0,0,4,44,2018-09-29T18:11:02.211Z,Facebook_10208710241577136,3
57,2018,4,Miami Dolphins,23,New England Patriots,24,1,0,0,0,1,0,-1,47,2018-09-29T18:11:17.849Z,Facebook_10208710241577136,4
59,2018,4,Cleveland Browns,24,Oakland Raiders,20,0,0,0,0,0,0,4,44,2018-09-29T18:11:49.352Z,Facebook_10208710241577136,0
58,2018,4,Seattle Seahawks,27,Arizona Cardinals,14,1,0,0,0,0,0,13,41,2018-09-29T18:12:11.910Z,Facebook_10208710241577136,2
61,2018,4,San Francisco 49ers,17,Los Angeles Chargers,28,1,0,0,0,0,0,-11,45,2018-09-29T18:13:50.211Z,Facebook_10208710241577136,2
60,2018,4,New Orleans Saints,28,New York Giants,23,1,0,1,0,1,0,5,51,2018-09-29T18:14:23.691Z,Facebook_10208710241577136,7
62,2018,4,Baltimore Ravens,28,Pittsburgh Steelers,27,1,0,1,0,0,0,1,55,2018-09-29T22:35:23.215Z,Facebook_10208710241577136,4
63,2018,4,Kansas City Chiefs,30,Denver Broncos,23,1,0,1,0,1,0,7,53,2018-09-29T22:36:12.813Z,Facebook_10208710241577136,7
56,2018,4,Philadelphia Eagles,27,Tennessee Titans,17,0,0,0,0,1,0,10,44,2018-09-30T00:02:01.958Z,Facebook_10154523075462819,2
55,2018,4,New York Jets,13,Jacksonville Jaguars,24,1,0,1,0,0,0,-11,37,2018-09-30T00:03:19.876Z,Facebook_10154523075462819,4
54,2018,4,Cincinnati Bengals,27,Atlanta Falcons,31,0,0,0,0,1,0,-4,58,2018-09-30T00:03:39.695Z,Facebook_10154523075462819,2
53,2018,4,Tampa Bay Buccaneers,20,Chicago Bears,24,1,0,1,0,0,0,-4,44,2018-09-30T00:06:23.475Z,Facebook_10154523075462819,4
52,2018,4,Houston Texans,27,Indianapolis Colts,24,1,0,1,0,1,0,3,51,2018-09-30T00:10:57.478Z,Facebook_10154523075462819,7
51,2018,4,Buffalo Bills,24,Green Bay Packers,34,1,0,1,0,0,0,-10,58,2018-09-30T00:11:18.957Z,Facebook_10154523075462819,4
50,2018,4,Detroit Lions,24,Dallas Cowboys,21,0,0,1,0,1,0,3,45,2018-09-30T00:11:34.237Z,Facebook_10154523075462819,5
57,2018,4,Miami Dolphins,21,New England Patriots,24,1,0,0,0,1,0,-3,45,2018-09-30T00:12:12.779Z,Facebook_10154523075462819,5
59,2018,4,Cleveland Browns,17,Oakland Raiders,21,1,0,1,0,0,0,-4,38,2018-09-30T00:14:30.897Z,Facebook_10154523075462819,4
58,2018,4,Seattle Seahawks,24,Arizona Cardinals,13,1,0,0,0,1,0,11,37,2018-09-30T00:14:51.116Z,Facebook_10154523075462819,5
61,2018,4,San Francisco 49ers,21,Los Angeles Chargers,41,1,0,0,0,1,0,-20,62,2018-09-30T00:15:12.438Z,Facebook_10154523075462819,4
60,2018,4,New Orleans Saints,24,New York Giants,23,1,0,0,0,1,0,1,47,2018-09-30T01:00:17.405Z,Facebook_10154523075462819,4
62,2018,4,Baltimore Ravens,24,Pittsburgh Steelers,27,0,0,0,0,0,0,-3,51,2018-09-30T01:01:12.842Z,Facebook_10154523075462819,0
51,2018,4,Buffalo Bills,17,Green Bay Packers,27,1,0,1,0,0,0,-10,44,2018-09-30T01:05:34.682Z,Facebook_10205896813734452,4
52,2018,4,Houston Texans,24,Indianapolis Colts,31,0,0,0,0,1,0,-7,55,2018-09-30T01:05:41.467Z,Facebook_10205896813734452,2
56,2018,4,Philadelphia Eagles,27,Tennessee Titans,24,0,0,0,0,1,0,3,51,2018-09-30T01:05:49.783Z,Facebook_10205896813734452,2
54,2018,4,Cincinnati Bengals,19,Atlanta Falcons,27,0,0,0,0,0,0,-8,46,2018-09-30T01:09:25.624Z,Facebook_10205896813734452,0
53,2018,4,Tampa Bay Buccaneers,21,Chicago Bears,31,1,0,1,0,1,0,-10,52,2018-09-30T01:09:36.906Z,Facebook_10205896813734452,6
55,2018,4,New York Jets,21,Jacksonville Jaguars,27,1,0,0,0,1,0,-6,48,2018-09-30T01:10:51.365Z,Facebook_10205896813734452,4
50,2018,4,Detroit Lions,21,Dallas Cowboys,27,1,0,0,0,1,0,-6,48,2018-09-30T01:11:04.963Z,Facebook_10205896813734452,4
57,2018,4,Miami Dolphins,21,New England Patriots,31,1,0,1,0,0,0,-10,52,2018-09-30T01:11:31.446Z,Facebook_10205896813734452,4
59,2018,4,Cleveland Browns,27,Oakland Raiders,24,0,0,0,0,1,0,3,51,2018-09-30T01:11:47.744Z,Facebook_10205896813734452,2
58,2018,4,Seattle Seahawks,27,Arizona Cardinals,24,1,0,1,0,0,0,3,51,2018-09-30T01:11:58.424Z,Facebook_10205896813734452,5
61,2018,4,San Francisco 49ers,17,Los Angeles Chargers,31,1,0,0,0,1,0,-14,48,2018-09-30T01:12:11.864Z,Facebook_10205896813734452,4
60,2018,4,New Orleans Saints,27,New York Giants,21,1,0,1,0,1,0,6,48,2018-09-30T01:12:21.643Z,Facebook_10205896813734452,6
62,2018,4,Baltimore Ravens,21,Pittsburgh Steelers,27,0,0,0,0,1,0,-6,48,2018-09-30T01:12:46.822Z,Facebook_10205896813734452,2
63,2018,4,Kansas City Chiefs,31,Denver Broncos,24,1,0,1,0,0,0,7,55,2018-09-30T01:12:58.284Z,Facebook_10205896813734452,4
59,2018,4,Cleveland Browns,21,Oakland Raiders,14,0,0,0,0,0,0,7,35,2018-09-30T18:29:09.534Z,Facebook_10155179314751475,0
58,2018,4,Seattle Seahawks,21,Arizona Cardinals,17,1,0,0,0,1,0,4,38,2018-09-30T18:29:12.394Z,Facebook_10155179314751475,5
61,2018,4,San Francisco 49ers,7,Los Angeles Chargers,21,1,0,0,0,0,0,-14,28,2018-09-30T18:29:35.232Z,Facebook_10155179314751475,2
60,2018,4,New Orleans Saints,31,New York Giants,10,1,0,1,0,1,0,21,41,2018-09-30T18:29:37.030Z,Facebook_10155179314751475,6
62,2018,4,Baltimore Ravens,20,Pittsburgh Steelers,21,0,0,1,0,1,0,-1,41,2018-09-30T18:29:51.867Z,Facebook_10155179314751475,4
63,2018,4,Kansas City Chiefs,21,Denver Broncos,28,0,0,0,0,1,0,-7,49,2018-09-30T18:30:56.191Z,Facebook_10155179314751475,2
50,2018,4,Detroit Lions,20,Dallas Cowboys,23,1,0,0,0,0,0,-3,43,2018-09-26T03:48:55.874Z,psmeyerlaw,2
50,2018,4,Detroit Lions,42,Dallas Cowboys,14,0,0,1,0,1,0,28,56,2018-09-27T21:48:34.934Z,ineverwin,4
57,2018,4,Miami Dolphins,20,New England Patriots,27,1,0,1,0,1,0,-7,47,2018-09-26T03:46:30.714Z,psmeyerlaw,6
57,2018,4,Miami Dolphins,24,New England Patriots,21,0,0,0,0,1,0,3,45,2018-09-27T21:46:33.095Z,ineverwin,3
57,2018,4,Miami Dolphins,10,New England Patriots,17,1,0,1,0,1,0,-7,27,2018-09-27T22:55:23.114Z,murreya,6
51,2018,4,Buffalo Bills,17,Green Bay Packers,27,1,0,1,0,0,0,-10,44,2018-09-26T03:48:36.054Z,psmeyerlaw,4
51,2018,4,Buffalo Bills,21,Green Bay Packers,20,0,0,0,0,1,0,1,41,2018-09-27T21:48:18.314Z,ineverwin,2
51,2018,4,Buffalo Bills,20,Green Bay Packers,24,1,0,0,0,0,0,-4,44,2018-09-27T22:57:11.592Z,murreya,2
54,2018,4,Cincinnati Bengals,23,Atlanta Falcons,28,0,0,0,0,0,0,-5,51,2018-09-26T03:47:18.216Z,psmeyerlaw,0
54,2018,4,Cincinnati Bengals,6,Atlanta Falcons,21,0,0,0,0,0,0,-15,27,2018-09-27T21:47:08.917Z,ineverwin,0
54,2018,4,Cincinnati Bengals,24,Atlanta Falcons,27,0,0,1,0,0,0,-3,51,2018-09-27T22:56:23.354Z,murreya,2
55,2018,4,New York Jets,17,Jacksonville Jaguars,24,1,0,0,0,1,0,-7,41,2018-09-27T22:56:08.012Z,murreya,4
56,2018,4,Philadelphia Eagles,35,Tennessee Titans,17,0,0,0,0,1,0,18,52,2018-09-27T22:55:45.612Z,murreya,2
52,2018,4,Houston Texans,22,Indianapolis Colts,24,0,0,0,0,0,0,-2,46,2018-09-26T03:48:16.935Z,psmeyerlaw,0
52,2018,4,Houston Texans,32,Indianapolis Colts,21,1,0,1,0,1,0,11,53,2018-09-27T21:47:32.946Z,ineverwin,6
52,2018,4,Houston Texans,14,Indianapolis Colts,27,0,0,0,0,0,0,-13,41,2018-09-27T22:57:02.014Z,murreya,0
58,2018,4,Seattle Seahawks,21,Arizona Cardinals,18,1,0,1,0,1,0,3,39,2018-09-26T03:49:41.437Z,psmeyerlaw,7
58,2018,4,Seattle Seahawks,21,Arizona Cardinals,20,1,0,1,0,0,0,1,41,2018-09-27T21:48:52.615Z,ineverwin,4
58,2018,4,Seattle Seahawks,24,Arizona Cardinals,14,1,0,0,0,1,0,10,38,2018-09-27T22:59:01.574Z,murreya,4
60,2018,4,New Orleans Saints,31,New York Giants,17,1,0,1,0,1,0,14,48,2018-09-27T22:59:44.732Z,murreya,6
59,2018,4,Cleveland Browns,21,Oakland Raiders,24,1,0,1,0,1,0,-3,45,2018-09-26T03:49:14.596Z,psmeyerlaw,7
59,2018,4,Cleveland Browns,14,Oakland Raiders,7,0,0,0,0,0,0,7,21,2018-09-27T21:48:43.257Z,ineverwin,0
59,2018,4,Cleveland Browns,10,Oakland Raiders,17,1,0,1,0,0,0,-7,27,2018-09-27T22:58:45.374Z,murreya,4
62,2018,4,Baltimore Ravens,21,Pittsburgh Steelers,35,0,0,0,0,0,0,-14,56,2018-09-27T22:59:56.995Z,murreya,0
63,2018,4,Kansas City Chiefs,31,Denver Broncos,21,1,0,1,0,1,0,10,52,2018-10-01T03:32:56.883Z,Facebook_10154523075462819,6
63,2018,4,Kansas City Chiefs,30,Denver Broncos,25,1,0,1,0,0,0,5,55,2018-09-26T03:51:07.376Z,psmeyerlaw,4
63,2018,4,Kansas City Chiefs,42,Denver Broncos,28,1,0,1,0,0,0,14,70,2018-09-27T21:52:02.874Z,ineverwin,4
63,2018,4,Kansas City Chiefs,27,Denver Broncos,17,1,0,1,0,1,0,10,44,2018-09-27T23:00:04.917Z,murreya,7
53,2018,4,Tampa Bay Buccaneers,21,Chicago Bears,24,1,0,0,0,0,0,-3,45,2018-09-26T03:48:00.195Z,psmeyerlaw,2
53,2018,4,Tampa Bay Buccaneers,14,Chicago Bears,17,1,0,0,0,0,0,-3,31,2018-09-27T21:47:19.933Z,ineverwin,2
53,2018,4,Tampa Bay Buccaneers,30,Chicago Bears,14,0,0,0,0,0,0,16,44,2018-09-27T22:56:41.635Z,murreya,0